Wo, Wo, Wo, Gs, Gs^Ft, Gs^Ft, Ds, Ww, Wo, Wo, Wo, Wo, Wo, Wo, Wo, Wo, Wo, Wo, Wo, Wo, Wo, Wo, Wo, Wo, Wo, Wo, Wo, Wo, Wo, Wo, Wo, Wo, Wo, Wo, Wo, Wo, Wo, Wo, Wo, Wo, Wo, Wo, Wo, Wo, Wo, Wo, Wo, Wo, Wo, Wo, Wo, Wo, Wo, Wo, Wo, Wo, Wo, Wo, Wo, Wo, Wo, Wo, Wo, Wo, Wo, Wo, Wo, Wo, Wo, Wo, Wo, Wo, Wo, Wo, Wo, Wo, Wo, Wo, Wo, Wo, Wo, Wo
Wo, Ww, Ww, Ds, Gs^Fds, Mm, Hh^Fms, Ds, Ww, Wo, Ww, Wo, Wo, Wo, Wo, Wo, Wwr, Wwr, Wo, Wo, Wo, Wo, Wo, Wo, Wo, Wo, Wo, Wo, Wo, Wo, Wo, Wo, Wo, Wo, Wo, Wo, Wo, Wo, Wo, Wo, Wo, Wo, Wo, Wo, Wo, Wo, Wo, Wo, Wo, Wo, Wo, Wo, Wo, Wo, Wo, Wo, Wo, Wo, Wo, Wo, Wo, Wo, Wo, Wo, Wo, Wo, Wo, Wo, Wo, Wo, Wo, Wo, Wo, Wo, Wo, Wo, Wwr, Wo, Ww, Wo, Wo, Wo
Wo, Ww, Ww, Ww, Gs^Ft, Mm, Gs^Ft, Ds, Gs, Ww, Ds, Ww, Ww, Ww, Wo, Wwr, Wwr, Wo, Wo, Wo, Wo, Wo, Wo, Wo, Wo, Wo, Wwr, Wwr, Wo, Wo, Wo, Wo, Wo, Wo, Wo, Wo, Wo, Wo, Wo, Wo, Wo, Wo, Wo, Wo, Wo, Wo, Wo, Wo, Wo, Wo, Wo, Wo, Wo, Wo, Wo, Ww, Ww, Ww, Wo, Wo, Wo, Wo, Wo, Wo, Wo, Wo, Wo, Wo, Wo, Wo, Wo, Wo, Wo, Wo, Wo, Wo, Wwr, Ww, Ww, Wo, Wo, Wo
Wo, Ww, Ww, Ww, Gs^Fds, Ds, Ds, Wo, Gs^Ft, Gs^Ft, Gs^Ft, Ds, Ww, Ww, Ww, Wwr, Wo, Wo, Wo, Wo, Wo, Wo, Wo, Wo, Wwr, Wwr, Wo, Wwr, Wo, Wo, Wo, Wo, Wo, Wo, Wo, Wo, Wo, Wo, Wo, Wo, Wo, Wo, Wo, Wwr, Wo, Wo, Wo, Wo, Wo, Wo, Wo, Wo, Wo, Wo, Wo, Ww, Ww, Ww, Wo, Wo, Wo, Wo, Wo, Wo, Wo, Wo, Wo, Wo, Wo, Wo, Wo, Wo, Wo, Wo, Wo, Wo, Wwr, Wwr, Wo, Wo, Wo, Wo
Wo, Wo, Wo, Wo, Ww, Gg^Efm, Ww, Wo, Wo, Mm, Mm, Ds, Ww, Ww, Wo, Wo, Wo, Wo, Wo, Wo, Wo, Wo, Wo, Wwr, Wwr, Wwr, Wo, Wo, Wo, Wo, Wo, Wo, Wo, Wo, Wo, Wo, Wo, Wo, Wo, Wo, Wo, Wwr, Wwr, Wwr, Wo, Wo, Wo, Wo, Wo, Wo, Wo, Wo, Wo, Wo, Wo, Wo, Ww, Ww, Wwr, Wo, Wo, Wo, Wo, Wo, Wo, Wo, Wo, Wo, Wo, Wo, Wo, Wo, Wo, Wo, Wo, Wo, Wo, Wo, Wo, Wo, Wo, Wo
Wo, Wo, Wwr, Ww, Ww, Ww, Ww, Ww, Ww, Hh^Fms, Gs^Ft, Gg^Efm, Ww, Wo, Ww, Wo, Wo, Wo, Wo, Wo, Wo, Wo, Wo, Wo, Wo, Wo, Wo, Wo, Wo, Wo, Wo, Wo, Wo, Wo, Wo, Wo, Wo, Wo, Wo, Wo, Wo, Wo, Wo, Wo, Wo, Wo, Wo, Wo, Wo, Wo, Wo, Wo, Wo, Wo, Wo, Wo, Ww, Ww, Wwr, Ww, Wo, Wo, Wo, Wo, Wo, Wo, Wo, Wo, Wo, Wo, Wo, Wo, Wo, Wo, Wo, Wo, Wo, Wo, Wo, Wo, Wo, Wo
Wo, Wo, Ww, Wwr, Wwr, Ww, Ww, Ww, Ww, Wo, Ds, Ww, Ww, Ww, Ww, Ds, Gg, Wo, Wo, Wo, Wo, Wo, Wo, Wo, Wo, Wo, Wo, Wo, Wo, Wo, Wo, Wo, Wo, Wo, Wo, Wo, Wo, Wo, Wo, Wo, Wo, Wo, Wo, Wo, Wo, Wo, Wo, Wo, Wo, Wo, Wo, Wo, Wo, Wo, Wo, Wo, Wo, Wwr, Wo, Wwr, Wo, Wo, Wo, Wo, Wo, Wo, Wo, Wo, Wo, Wo, Wo, Wo, Wo, Wo, Wo, Wo, Wo, Wo, Wo, Wo, Wo, Wo
Wo, Ww, Wwr, Wwr, Wwr, Ww, Ww, Ww, Gs^Ft, Gs^Ft, Gs^Ft, Gg, Ww, Ww, Gs^Ft, Gs^Ft, Hh^Fms, Ds, Wo, Wo, Wo, Wo, Wo, Wo, Wo, Wo, Wo, Wo, Wo, Wo, Wo, Wo, Wo, Wo, Wo, Wo, Wo, Wo, Wo, Wo, Wo, Wo, Wo, Wo, Wo, Wo, Wo, Wo, Wo, Wo, Wo, Wo, Wo, Wo, Wo, Wo, Wo, Wo, Wo, Wo, Wo, Wo, Wo, Wo, Wo, Wo, Wo, Wwr, Wwr, Wo, Wo, Wo, Wo, Wo, Wo, Wo, Wo, Ww, Wo, Wo, Wo, Wo
Wo, Wo, Ww, Wwr, Ww, Ww, Gs, Ds, Gs^Ft, Gs^Fds, Wo, Ww, Ww, Ds, Hh^Fms, Mm, Mm, Gg^Efm, Ww, Wo, Wo, Wo, Wo, Wo, Wo, Wo, Wo, Wo, Wo, Wo, Wo, Wo, Wo, Wo, Wo, Wo, Ww, Wo, Wo, Wo, Wo, Wo, Wo, Wo, Wo, Wo, Wo, Wo, Wo, Wo, Wo, Wo, Wo, Wo, Wo, Wo, Wo, Wo, Wo, Wo, Wo, Wo, Wo, Wo, Wo, Wo, Wwr, Wwr, Wwr, Wo, Wo, Wo, Wo, Wo, Wo, Ww, Ww, Ww, Ww, Wo, Wo, Wo
Wo, Wo, Wo, Ww, Ww, Ww, Gs^Ft, Gs^Fds, Ds, Gs^Ft, Wo, Ww, Ww, Ds, Gs^Ft, Mm, Gg^Efm, Ww, Ww, Wo, Wwr, Wo, Ww, Ww, Ww, Ww, Wo, Wo, Wo, Wo, Wo, Wo, Ww, Ww, Ww, Ww, Ww, Wo, Ww, Wo, Wo, Wo, Wo, Wo, Wo, Wo, Wo, Wo, Wo, Wo, Wo, Wo, Wo, Wo, Wo, Wo, Wo, Wo, Wo, Wo, Wo, Wo, Wo, Wo, Wo, Wo, Wwr, Wo, Wo, Wo, Wo, Wo, Wo, Wo, Wo, Wo, Ww, Ww, Wo, Wo, Wo, Wo
Wo, Wo, Wo, Wo, Ww, Wo, Ww, Ds, Ww, Ww, Ww, Wo, Ww, Wo, Ds, Gs^Ft, Gs, Ww, Wo, Wwr, Wo, Ww, Ww, Ww, Gg, Ww, Wo, Wo, Wo, Wo, Ww, Ww, Ww, Ww, Wo, Gg^Efm, Gs^Ft, Ww, Ww, Wo, Wo, Wo, Wo, Wo, Wo, Wo, Wo, Wo, Wo, Wo, Wo, Wo, Wo, Wo, Wo, Wo, Wo, Wo, Wo, Wo, Wo, Wo, Wo, Wo, Wo, Wo, Wo, Wwr, Wo, Wo, Wo, Wo, Wo, Wo, Wo, Wo, Wo, Wo, Wo, Wo, Wo, Wo
Wo, Wo, Wo, Wo, Wwr, Wo, Ww, Wo, Wo, Wo, Wo, Ww, Ww, Wo, Ww, Ww, Wo, Ww, Ww, Gg, Gs^Fp, Gg^Vc, Gg^Fet, Gg^Efm, Ww, Ww, Wo, Wo, Wo, Wo, Wo, Ww, Wo, Ww, Wo, Gs^Fds, Mm, Gs^Ft, Ww, Wo, Ww, Wo, Wo, Wo, Wo, Wo, Wo, Wo, Wo, Wo, Wo, Wo, Wo, Wo, Wo, Wo, Wo, Wo, Wo, Wo, Wwr, Wo, Wo, Wo, Wo, Wo, Wo, Wo, Wo, Wo, Wo, Wo, Wo, Wo, Wo, Wo, Wo, Wo, Wo, Wo, Wo, Wo
Wo, Wo, Wo, Wo, Wwr, Wo, Wo, Wo, Wo, Wo, Wo, Wo, Wo, Ww, Gs, Ww, Ww, Ww, Gs^Ft, Gs^Ft, Mm, Mm^Xm, Hh, Gs^Ft, Ww, Ww, Wo, Wo, Wo, Wo, Wo, Wo, Wo, Ww, Gs^Ft, Mm, Mm, Hh, Ww, Ww, Ww, Ww, Ww, Wo, Wo, Wo, Wo, Wo, Wo, Wo, Wo, Wo, Wo, Wo, Wo, Wo, Wo, Wo, Wo, Wo, Wwr, Wwr, Ww, Wo, Wo, Wo, Wo, Wo, Wo, Wo, Wo, Wo, Wo, Wo, Wo, Wo, Wo, Wo, Wo, Wo, Wo, Wo
Wo, Wo, Wo, Wo, Wwr, Wwr, Wo, Wo, Wo, Wo, Wo, Wo, Ww, Gg, Gs, Gg, Gg^Vc, Gs^Ft, Hh, Gs^Ft, Gs^Ft, Hh^Fms, Re^Gvs, Ww, Ww, Wo, Wo, Wo, Wo, Wo, Wo, Wo, Ww, Gs^Ft, Gs^Fds, Hh, Gs^Ft, Hh, Gs^Ft, Ww, Gs^Ft, Ww, Ww, Wo, Ww, Wo, Wo, Wo, Wo, Wo, Wo, Wo, Wo, Wo, Wo, Wo, Wo, Wo, Wo, Wwr, Wwr, Wwr, Ww, Wo, Wo, Wo, Wo, Wo, Wo, Wo, Wo, Wo, Wo, Wo, Wo, Wo, Wo, Wo, Wo, Wo, Wo, Wo
Wo, Wo, Wo, Wwr, Wwr, Wo, Wwr, Wwr, Wo, Wo, Wo, Wo, Ww, Gg^Efm, Hh, Hh, Hh^Fms, Gs^Fp, Mm, Hh^Fms, Gs^Fp, Gs, Re^Gvs, Ww, Wo, Wo, Ww, Wo, Wo, Wo, Wo, Wo, Wo, Ww, Ww, Ww, Ww, Gs^Fds, Gs^Ft, Gs^Ft, Hh, Gs^Ft, Gs^Ft, Gs^Ft, Ww, Ww, Wo, Wo, Wo, Wo, Wo, Wo, Wo, Wo, Wo, Wo, Wo, Ww, Wo, Ww, Ww, Ww, Wo, Wo, Wo, Wo, Wo, Wo, Wo, Wo, Wo, Wo, Wo, Wo, Wo, Wo, Wo, Wo, Wo, Wo, Wo, Wo
Wo, Wo, Wo, Wo, Wo, Wwr, Wwr, Wo, Wo, Wo, Ww, Ww, Gg, Gs^Ft, Mm, Mm, Mm^Xm, Mm, Hh^Fdf, Mm, Gs, Gs^Vl, Ww, Ww, Wo, Wo, Wo, Ww, Wo, Wo, Wo, Wo, Wo, Wo, Wo, Ww, Ww, Gs, Gs^Vc, Mm, Mm, Mm, Gs^Fds, Gs^Ft, Gs, Wo, Ww, Ww, Ww, Wo, Wo, Wo, Wo, Wo, Wo, Wo, Wo, Ww, Ww, Ww, Ww, Wo, Wo, Wo, Wo, Wo, Wo, Wo, Wo, Wo, Wo, Wo, Wo, Wo, Wo, Wo, Wo, Wo, Wo, Wo, Wo, Wo
Wo, Wo, Wo, Wo, Wo, Wo, Wo, Wo, Ww, Gg, Gs, Gg^Efm, Gs^Fp, Gs^Ft, Mm, Mm^Xm, Mm, Gg^Fet, Gs^Ft, Gs^Ft, Re^Gvs, Ww, Ww, Wo, Wo, Ww, Ww, Ww, Wo, Wo, Wo, Wo, Wwr, Wo, Wo, Ww, Wo, Wo, Wo, Gs^Ft, Mm, Hh, Mm, Hh, Hh, Gs^Ft, Gs^Ft, Ww, Ww, Wo, Wo, Wo, Wo, Wo, Wo, Wo, Wo, Ww, Wo, Ww, Wo, Wo, Wo, Wo, Wo, Wo, Wo, Wo, Wo, Wo, Wo, Wo, Wo, Wo, Wo, Wo, Wo, Wo, Ww, Wo, Wo, Wo
Wo, Wo, Wo, Wo, Wo, Wo, Wo, Ww, Ww, Gs, Gs^Ft, Gg^Vc, Hh^Fms, Mm, Mm^Xm, Mm, Gs^Fds, Hh^Fms, Gs^Ft, Re^Gvs, Ww, Ww, Wo, Wo, Wo, Wo, Wo, Wo, Wo, Wwr, Wwr, Wwr, Wwr, Wwr, Wo, Wo, Wo, Ww, Ww, Gs^Ft, Gs^Ft, Gs^Efm, Mm, Mm, Hh, Gs^Ft, Ww, Ww, Wo, Wo, Wo, Wo, Wo, Wo, Wo, Wo, Wo, Wo, Wo, Ww, Wo, Wo, Wo, Wo, Wo, Wo, Wo, Wo, Wo, Wo, Wo, Wo, Wo, Wo, Wo, Wo, Ww, Wo, Wo, Wo, Wo, Wo
Wo, Wo, Wo, Wo, Wwr, Wo, Wo, Ww, Ww, Gs, Gs^Ft, Hh, Mm, Mm^Xm, Hh, Ww, Ww, Gs^Ft, Gs^Ft, Gg^Vl, Wo, Ww, Wo, Ww, Wo, Wo, Ww, Wo, Ww, Wo, Wwr, Wwr, Wo, Wwr, Wo, Wo, Wo, Wo, Ww, Ww, Ww, Gs^Vc, Gs^Ft, Mm, Mm, Hh, Gs^Ft, Ww, Wo, Wo, Wo, Wo, Wo, Wo, Wo, Wo, Wo, Wo, Wo, Wo, Wo, Wo, Wo, Wo, Wo, Wo, Wo, Wo, Wo, Wo, Wo, Wo, Wo, Wo, Ww, Ww, Wo, Ww, Wo, Wo, Wo, Wo
Wo, Wo, Wo, Wwr, Wwr, Wwr, Wo, Ww, Ww, Gs^Ft, Gs^Fds, Hh^Fdf, Mm, Hh^Fp, Gs^Ft, Gs^Fds, Gs^Ft, Ww, Gs, Gg, Ww, Ww, Wo, Ww, Ww, Wo, Wo, Ww, Ww, Wo, Ww, Ww, Ww, Wo, Wo, Wo, Wo, Wo, Wo, Ww, Ww, Gs^Ft, Gs^Ft, Gs, Gs^Ft, Gs^Fds, Mm, Ww, Wo, Wo, Wo, Wo, Wo, Wo, Wo, Wo, Wo, Wo, Wo, Wo, Wo, Wo, Wo, Wo, Wo, Wo, Wo, Wo, Wo, Wo, Wo, Wo, Wo, Wo, Wo, Wo, Wo, Wo, Wo, Wo, Wo, Wo
Wo, Wo, Wo, Wwr, Wo, Wo, Ww, Ww, Gs, Gg^Vc, Mm, Hh^Fms, Gs^Ft, Gs^Ft, Gg^Vl, Gs^Fp, Re^Gvs, Ww^Bw/, Re^Gvs, Re^Gvs, Ww, Wo, Ww, Ww, Ww, Wo, Wo, Wo, Ww, Ww, Ww, Ww, Ww, Ww, Wo, Wo, Wo, Wo, Wo, Wo, Wo, Wo, Wo, Gs^Fds, Ww, Hh, Mm, Hh, Ww, Wo, Wo, Wo, Wo, Wo, Wo, Wo, Wo, Wo, Wo, Wo, Wo, Wo, Wwr, Wo, Wo, Wo, Ww, Wo, Wo, Wo, Wo, Wo, Wo, Wo, Wo, Wo, Wo, Wo, Wo, Wo, Wo, Wo
Wo, Wo, Wo, Wo, Wo, Ww, Ww, Ww, Hh, Mm^Xm, Hh, Gs^Fp, Wo, Gg, Wo, Re^Gvs, Ww, Ww, Ww, Wo, Ww, Wo, Wo, Wo, Wo, Wo, Wo, Wo, Gs, Ss, Ss, Ss, Gg, Gs, Wo, Wo, Wo, Wo, Wo, Wo, Wo, Wo, Wo, Wo, Wo, Ww, Ww, Gs^Ft, Ww, Ww, Wo, Wo, Wo, Wo, Wo, Wo, Wo, Wo, Wo, Wo, Wo, Wo, Wo, Wwr, Wwr, Wo, Ww, Wo, Wo, Wo, Wo, Wo, Wo, Wo, Wo, Wo, Wo, Wo, Wo, Wo, Wo, Wo
Wo, Wo, Wo, Wo, Ww, Ww, Gs^Fds, Gg^Fet, Mm, Mm, Gs, Wo, Ww, Wo, Wo, Wo, Wo, Ww, Wo, Wo, Wo, Wo, Wo, Wwr, Wwr, Wo, Ss, Gs^Vud, Gg^Efm, Gs^Ft, Gs^Ft, Gg^Efm, Gg, Gs^Vud, Wo, Wo, Wo, Wo, Wo, Wo, Wo, Wo, Wo, Wo, Wo, Ww, Ww, Ww, Wo, Wo, Wo, Wo, Wo, Wo, Wo, Wo, Wo, Wo, Wo, Wo, Wo, Wo, Wo, Wwr, Wo, Ww, Ww, Ww, Ww, Wo, Wo, Wo, Wo, Wo, Wo, Wo, Wo, Wo, Wo, Wo, Wo, Wo
Wo, Wo, Wo, Wo, Gs^Ft, Gs^Ft, Gs^Fp, Hh^Fp, Gs^Ft, Hh^Fdf, Wo, Wo, Ww, Ww, Wo, Wwr, Wo, Wo, Wo, Wo, Wo, Ww, Ww, Wwr, Wwr, Wo, Ww, Ss, Ss, Ss, Gs^Ft, Gs^Ft, Ss, Wo, Wo, Wo, Wwr, Wo, Wo, Wo, Wo, Wo, Wo, Wo, Wo, Wo, Wo, Wo, Wo, Wo, Wo, Wo, Wo, Wo, Wo, Wo, Wo, Wo, Wo, Wo, Wo, Wo, Wo, Ww, Ww, Wo, Ww, Wo, Wo, Wo, Wo, Wo, Wo, Wo, Wo, Wo, Wo, Wo, Wo, Wo, Wo, Wo
Wo, Wo, Wo, Gs^Ft, Gs^Ft, Gs^Fds, Ww, Ww, Wo, Wo, Wo, Ww, Ww, Ww, Ds, Gg, Gs^Ft, Ww, Ds, Wo, Wo, Wo, Ww, Ww, Wo, Wo, Ww, Ss, Ss, Ss, Ss, Gs^Ft, Ww, Wo, Wwr, Wwr, Wwr, Wo, Wo, Wo, Wwr, Wwr, Wo, Wo, Wo, Wo, Wo, Wo, Wo, Wo, Wo, Wo, Wo, Wo, Wo, Wo, Wo, Wo, Wwr, Wwr, Wo, Wo, Wo, Wo, Wo, Wo, Wo, Wo, Wo, Wo, Wo, Wo, Wo, Wo, Wo, Wo, Wo, Wo, Wo, Wo, Wo, Wo
Wo, Wo, Wo, Ww, Wo, Wo, Wo, Wo, Ww, Wo, Ww, Ww, Gs, Gg, Gs^Ft, Gs^Ft, Gs^Ft, Gg, Gs, Ds, Ds, Wo, Ww, Ww, Ww, Wo, Wo, Ww, Ww, Ww, Ww, Ww, Ww, Wo, Wo, Wo, Wwr, Wo, Wo, Wwr, Wwr, Wwr, Wo, Wo, Wo, Wo, Wo, Wo, Wo, Wo, Wo, Wo, Wo, Wo, Wo, Wo, Wo, Wo, Wwr, Wwr, Wo, Wo, Wo, Wo, Wo, Wo, Wo, Wo, Wo, Wo, Wo, Wo, Wo, Wo, Wwr, Wo, Wo, Wo, Wo, Wo, Wo, Wo
Wo, Wo, Wwr, Wo, Ww, Wo, Wo, Ww, Ww, Ww, Ww, Ww, Gs, Gs^Ft, Hh, Hh, Mm, Gs^Ft, Gs^Ft, Gs, Gg^Efm, Wo, Wo, Ww, Ww, Wwr, Wwr, Wo, Wo, Ww, Ww, Wo, Wo, Wo, Wo, Wo, Wo, Wo, Wo, Wo, Wo, Wo, Wo, Wo, Ww, Wo, Ww, Ww, Wo, Wo, Wo, Wo, Wo, Wo, Wo, Wo, Wo, Wwr, Wwr, Wwr, Wo, Wo, Wo, Wo, Wo, Wo, Wo, Wo, Wo, Wo, Wo, Wo, Wo, Wo, Wwr, Wwr, Wwr, Wo, Wo, Wo, Wo, Wo
Wo, Wo, Wwr, Wwr, Wo, Ww, Ww, Ww, Wo, Wo, Re^Gvs, Gs^Ft, Gs^Ft, Gs^Ft, Gs^Ft, Mm, Mm^Xm, Hh, Gs^Fds, Gg^Vc, Hh, Gg, Gs, Wo, Wo, Wo, Wo, Wo, Wo, Wo, Wo, Wo, Wo, Wo, Wo, Wo, Wo, Wo, Wo, Ww, Ww, Wo, Ds, Ww, Wo, Ww, Ww, Ww, Wo, Wo, Wo, Wo, Wo, Wo, Wo, Wo, Wo, Wo, Wo, Wwr, Wo, Wo, Wo, Wo, Wo, Wo, Wo, Wo, Wo, Wo, Wo, Wo, Wo, Wo, Wo, Wo, Wo, Wo, Wo, Wo, Wo, Wo
Wo, Wo, Wo, Wwr, Wo, Ww, Ww, Wo, Wo, Ds, Gs^Ft, Gg^Vl, Mm, Gs^Fdf, Hh^Fds, Hh^Fp, Gg^Fet, Hh^Fp, Mm, Mm, Mm, Gs^Ft, Gg^Vc, Ww, Wo, Wo, Wo, Wo, Ww, Wo, Ww, Ww, Wwr, Wwr, Ww, Wo, Wo, Wo, Ww, Ww, Rd, Ww, Rp, Ds, Rr, Ww, Ww, Ww, Wo, Wo, Ww, Wo, Wo, Wo, Ww, Wo, Wo, Wo, Wo, Wo, Wo, Wo, Wo, Wo, Wo, Wo, Wo, Wo, Wo, Wo, Wo, Wo, Wo, Wo, Wwr, Wo, Wo, Wo, Wo, Wo, Wo, Wo
Wo, Wo, Wo, Wo, Wo, Ww, Ww, Ww, Gg, Gs^Ft, Hh, Hh, Mm^Xm, Gs^Fds, Gs, Mm, Mm^Xm, Mm, Gs^Fds, Hh, Gs^Ft, Hh, Gg, Ww, Wo, Wo, Wo, Wo, Wo, Ww, Ww, Wwr, Wwr, Wwr, Ww, Wo, Wo, Wo, Rd, Rd, Hh, Rp^Vhc, Hh^Fdf, Rr, Hh^Fms, Rr, Rd, Wo, Rr^Vhc, Wo, Ww, Ww, Ww, Wo, Ww, Ww, Wo, Wo, Wo, Wo, Wo, Wo, Wo, Wo, Wo, Wo, Wo, Wo, Wo, Wo, Ww, Wo, Wo, Wo, Wwr, Wo, Wo, Wo, Wo, Wo, Wo, Wo
Wo, Wo, Wo, Wo, Wo, Wo, Ww, Wo, Gg^Efm, Gs^Ft, Gs^Fds, Mm, Mm, Mm, Gg^Vl, Mm^Xm, Mm^Xm, Hh^Fdf, Ww, Hh, Gs^Ft, Gs^Ft, Gg^Efm, Gs, Gg, Wo, Wo, Wo, Wo, Wwr, Wwr, Wo, Wo, Ww, Wo, Wo, Re^Gvs, Rd, Mm, Hh^Fms, Mm, Gs^Fds, Mm, Mm, Mm, Mm, Hh, Rd, Gs^Ft, Rr, Rr, Ww, Ww, Ww, Ww, Ww, Wo, Wo, Wo, Wo, Wo, Wo, Wo, Wo, Wo, Wo, Wo, Wo, Ww, Wo, Wo, Wo, Ww, Wwr, Ww, Ww, Wo, Wo, Wo, Wo, Wo, Wo
Wo, Wo, Wwr, Wo, Wo, Ww, Ww, Ww, Ww, Re^Gvs, Gs^Vl, Hh, Hh^Fms, Gs^Ft, Gg^Fet, Hh^Fp, Hh^Fds, Mm, Gs^Fdf, Ww, Ww, Ds, Ds, Gs, Gs, Wo, Wo, Wo, Wo, Wo, Wo, Wo, Ww, Wo, Ww, Wo, Rd, Rd, Mm, Mm^Xm, Gs^Ft, Mm^Xm, Hh, Gs^Fms, Gs^Ft, Gs^Ft, Re^Gvs, Gs^Ft, Re^Gvs, Gs^Ft, Rp, Re^Gvs, Re^Gvs, Ds, Wo, Ww, Wo, Wo, Wo, Wo, Wo, Wo, Wo, Wo, Wo, Wo, Wo, Wo, Wo, Wo, Wo, Ww, Ww, Ww, Wo, Wo, Wo, Wo, Wo, Wo, Wo, Wo
Wo, Wwr, Ww, Wwr, Ww, Ww, Ww, Ww, Ww, Ww, Gs, Gs^Ft, Gs^Ft, Gg, Hh, Mm, Mm, Mm, Ww, Gs^Ft, Gs^Ft, Ww^Bw|, Ww, Ds, Ww, Wo, Wo, Wo, Wo, Wo, Ww, Wwr, Ww, Ww, Ww, Wo, Rd^Vh, Hh^Fms, Mm, Mm^Xm, Hh^Fms, Gs^Fds, Gg^Fet, Gs^Ft, Rr, Rr, Rr, Re^Gvs, Rr, Rp, Ds, Rp, Rr, Ds, Ds, Ww, Ww, Wo, Wo, Wo, Wo, Wo, Wo, Wo, Wo, Wo, Wo, Wo, Wo, Wo, Wo, Wo, Wo, Wo, Wo, Wo, Wo, Wo, Wo, Wo, Wo, Wo
Wo, Wwr, Ww, Ww, Ww, Ww, Ww, Wo, Wo, Ww, Re^Gvs, Gg, Gg^Efm, Gs^Ft, Gs^Fds, Mm^Xm, Gs^Ft, Ww, Mm, Gs^Ft, Gs^Ft, Gg, Ww, Ww, Wwr, Wo, Wo, Wo, Wwr, Wo, Wwr, Ww, Ww, Wo, Ww, Rd, Hh^Fdf, Re^Gvs, Mm, Gs^Ft, Gs, Gs^Ft, Rp, Rp, Ds, Ds, Ds, Rp^Vhc, Wo, Wo, Wo, Ds, Gg^Efm, Rp, Gs^Ft, Ww, Ww, Ww, Wo, Wo, Wo, Wo, Wo, Wo, Wo, Wo, Wo, Wo, Wo, Wo, Wo, Wo, Wo, Wo, Wo, Wo, Wo, Wo, Wo, Wo, Wo, Wo
Wo, Wwr, Wo, Ww, Ww, Ww, Ww, Wo, Ww, Ww, Re^Gvs, Gs, Re^Gvs, Gg^Efm, Re^Gvs, Gs^Ft, Gs^Ft, Ww, Mm, Hh, Gs^Vh, Gs, Ww, Ww, Wwr, Wwr, Wwr, Wo, Wwr, Wwr, Ww, Wo, Gg, Ww, Rd, Ww^Bw|, Ww, Mm^Xm, Hh^Fds, Gs^Ft, Re^Gvs, Rr, Ds, Ds, Wo, Ds, Wo, Wo, Wo, Ww, Wo, Wo, Ds, Rr, Gs, Ww, Ww, Ww, Wo, Wo, Wo, Wo, Wo, Wo, Wo, Wo, Wo, Ww, Ww, Wo, Wo, Wo, Wo, Wo, Wo, Wo, Wo, Wo, Wo, Wo, Wo, Wo
Wo, Wo, Wo, Ww, Wwr, Ww, Wo, Wo, Wo, Wo, Wo, Re^Gvs, Gs^Vl, Re^Gvs, Gs, Gg, Ds, Ww^Bw\, Hh, Hh, Gs, Wo, Ww, Wo, Ww, Ww, Wwr, Wo, Wwr, Wwr, Ww, Ww, Rd, Rd, Gs^Ft, Rd, Hh, Ww, Gs^Ft, Re^Gvs, Re^Gvs, Rr, Ds, Wo, Ww, Wo, Wo, Ww, Ww, Ww, Wo, Wo, Wo, Rp^Vhc, Wo, Gs^Ft, Wo, Wo, Ww, Wo, Wo, Wwr, Wwr, Wo, Wo, Wo, Wo, Ww, Ww, Ww, Wo, Wo, Wo, Wo, Wo, Wo, Wo, Wo, Wo, Wo, Wo, Wo
Wo, Wo, Wo, Wo, Wwr, Wwr, Wwr, Wo, Wo, Wo, Wo, Wo, Wo, Gs, Ds, Wwf, Wwf, Wwf, Wwf, Wwf, Wwf, Ww, Ww, Ww, Ww, Ww, Wo, Wo, Wo, Wo, Ww, Ww, Rd^Vh, Gs^Ft, Gs^Fds, Gs^Ft, Gs^Ft, Ww, Ww, Ds, Ww, Rr^Vhc, Ww, Ww, Wo, Ww, Ww, Ww, Ww, Ww, Wo, Wo, Wo, Wo, Ww, Wo, Ww, Wo, Ww, Wo, Wo, Wwr, Wo, Wo, Wo, Wo, Wo, Wo, Wo, Wo, Ww, Wo, Wo, Wo, Wo, Wo, Wo, Wo, Wo, Wo, Wo, Wo
Wo, Wo, Wo, Wo, Wo, Wwr, Wwr, Ww, Ww, Wo, Ww, Wo, Wo, Ww, Wwf, Wwf, Ds, Wwf, Gg, Wwf, Ds, Wwf, Wwf, Wo, Ds, Ww, Wo, Wo, Ww, Ww, Re^Gvs, Rd, Gs^Ft, Gs^Ft, Gs^Fds, Gg^Fet, Gs^Ft, Gs^Ft, Gs, Ww, Ds, Wo^Bw|, Ww, Ww, Wo, Wo, Wwr, Ww, Wo, Wo, Ss, Wo, Wo, Wo, Ww, Ww, Ww, Ww, Wo, Wo, Wo, Wo, Wo, Wo, Wo, Wo, Wo, Wo, Wo, Wo, Wo, Wo, Wo, Wo, Wo, Wo, Wo, Wo, Wo, Wo, Wo, Wo
Wo, Wo, Wo, Wo, Wwr, Wwr, Wo, Ww, Ww, Wo, Ww, Ww, Wo, Ww, Wwf, Wwf, Gs, Gs, Gs^Ft, Gs^Ft, Gs^Ft, Gs, Gg^Vh, Gs, Gg^Efm, Ds, Re^Gvs, Wo, Wo, Ww, Ds, Rd, Gs^Fms, Gs^Ft, Gs, Gs^Fds, Hh, Gs^Ft, Gs, Ds, Gg, Rr, Ds, Ww, Ww, Wwr, Wwr, Ww, Wo, Ss, Gg, Gs^Ft, Gg, Ss, Ww, Ww, Ww, Wo, Wo, Wo, Wo, Wo, Wo, Wo, Wo, Wo, Wo, Wo, Wo, Wo, Wo, Wo, Wo, Wo, Wo, Wo, Wo, Wo, Wo, Wo, Wo, Wo
Wo, Wo, Wo, Wo, Wo, Wo, Wo, Ww, Wo, Ww, Wo, Ww, Wo, Ww, Ds, Gg^Efm, Gs^Ft, Mm, Gs^Ft, Hh, Gs^Fds, Gs^Ft, Hh, Gs^Ft, Gs^Ft, Re^Gvs, Gg^Efm, Re^Gvs, Ds, Wo, Wo, Ds, Ds, Gs, Gs^Ft, Hh, Mm, Hh, Hh^Fdf, Gs^Ft, Gs^Ft, Rp, Ds, Wo, Wo, Wwr, Ww, Ww, Wo, Wo, Wo, Gg^Vud, Wo, Ss, Wo, Wo, Wwr, Wwr, Wo, Ww, Ww, Wo, Wo, Ww, Ww, Wo, Ww, Wo, Wo, Wo, Wo, Wo, Wo, Wo, Wo, Wo, Wo, Wo, Wo, Wo, Wo, Wo
Wo, Wo, Wo, Wo, Wo, Wo, Wo, Wo, Wo, Ww, Wo, Wo, Wo, Wo, Ds, Ds, Gs^Ft, Gs^Fds, Mm, Mm, Gg^Fet, Mm, Mm, Hh, Gs^Ft, Gg^Vh, Gg, Ds, Wo, Wo, Wo, Ds, Re^Gvs, Gs^Ft, Gs^Fds, Hh^Fms, Mm, Hh^Fms, Mm, Hh, Gs^Ft, Rp, Rp^Vhc, Wo, Wo, Wo, Ww, Ww, Wo, Wo, Wo, Wo, Wo, Wo, Wo, Wwr, Wo, Wo, Ww, Gg, Gs, Gg^Vl, Re^Gvs, Ww, Re^Gvs, Ww, Gg, Ww, Ww, Ww, Ww, Wo, Wo, Wo, Wo, Wo, Wo, Wo, Wo, Wo, Wo, Wo
Wo, Wo, Wo, Wo, Wo, Wo, Wo, Wo, Wo, Wo, Wo, Wo, Wo, Wo, Wo, Gs, Gs, Gg^Vc, Gs^Fds, Gs^Ft, Mm, Mm^Xm, Gs^Fdf, Mm, Gs^Ft, Gs^Ft, Gs, Wwf, Wwf, Ww, Wo, Gs, Re^Gvs, Gs^Ft, Hh, Hh, Mm, Mm, Gs^Fds, Hh, Gs^Ft, Gg, Rr, Ds, Ds, Wo, Wo, Wo, Ww, Ww, Ww, Ww, Ww, Wo, Ww, Wwr, Wo, Ww, Ww, Re^Gvs, Re^Gvs, Re^Gvs, Gs^Ft, Gs^Ft, Hh, Gs^Ft, Gs^Ft, Gs, Gs^Ft, Gg, Ww, Ww, Wo, Wo, Wo, Wo, Wo, Wwr, Wwr, Wo, Wo, Wo
Wo, Wo, Wo, Wo, Wo, Wo, Wo, Ww, Ww, Ww, Ww, Wo, Wo, Wo, Ww, Wo, Ds, Gs^Ft, Gs^Ft, Gs^Ft, Gs^Fds, Hh, Gs^Ft, Gg^Efm, Gs^Fds, Gs^Ft, Gg, Gs, Ds, Wwf, Wwf, Ds, Ds, Gs^Vh, Gs^Ft, Gs^Ft, Hh^Fms, Mm^Xm, Mm^Xm, Gs^Fds, Mm, Re^Gvs, Re^Gvs, Rp, Ds, Ds, Ds, Wo, Wo, Wo, Wwr, Ww, Wwr, Ww, Wo, Wo, Wo, Ww, Re^Gvs, Re^Gvs, Re^Gvs, Gs^Ft, Gs^Ft, Hh, Mm, Mm, Mm, Mm, Mm, Gs^Ft, Ww, Ww, Ww, Wo, Wo, Wo, Wwr, Wwr, Wo, Wo, Wo, Wo
Wo, Wo, Wo, Wo, Wo, Wo, Ww, Ww, Ww, Ww, Ww, Ww, Wo, Wo, Wo, Ww, Ww, Ds, Gs^Ft, Gs^Ft, Gg^Vc, Gg^Fet, Hh^Fds, Mm^Xm, Hh^Fds, Gs^Ft, Gg^Vh, Ds, Wwf, Wwf, Wwf, Wwf, Wo, Rd, Rd, Gs^Ft, Hh, Mm, Hh^Fms, Mm^Xm, Mm, Re^Gvs, Re^Gvs, Rr, Rp^Vhc, Re^Gvs, Ds, Wo, Wo, Wo, Wo, Wwr, Wo, Wo, Wo, Wo, Wo, Wo, Wo, Gg^Vl, Re^Gvs, Re^Gvs, Gs^Ft, Hh, Mm, Uh, Ql, Uh, Mm, Gs^Ft, Gs^Ft, Ww, Ww, Wo, Ww, Wo, Wwr, Wwr, Wo, Wo, Wo, Wo
Wo, Wo, Wo, Wo, Wo, Wo, Ww, Ww, Ww, Ww, Ww, Ww, Wo, Wo, Wo, Ww, Ww, Ww, Ds, Gs, Gg^Efm, Gs^Ft, Gs^Ft, Hh, Mm, Hh, Re^Gvs, Wwf, Ww, Ww, Wo, Wo, Ww, Ds, Rd, Gs^Ft, Gs^Ft, Hh^Fdf, Hh, Mm, Hh^Fds, Hh, Hh, Re^Gvs, Gg^Efm, Rp, Rp, Gg^Efm, Wo, Wo, Wo, Wo, Wo, Wo, Wo, Wo, Wo, Wo, Wo, Gs, Ww, Re^Gvs, Ww, Re^Gvs, Gs^Ft, Mm, Qlf, Qlf, Qlf, Mm, Mm, Mm, Mm, Wo, Ww, Wo, Wwr, Wwr, Wo, Wo, Wo, Wo
Wo, Wo, Wo, Wo, Wo, Wo, Wo, Wo, Wwr, Wwr, Ww, Ww, Wo, Wo, Ww, Wo, Wo, Ww, Wo, Ds, Ds, Gs^Ft, Gs, Gs^Fdf, Hh, Gs^Ft, Gs^Ft, Wwf, Wwf, Wo, Ww, Ww, Ww, Re^Gvs, Rd^Vh, Gs^Ft, Gg^Fet, Gs^Ft, Hh^Fds, Mm^Xm, Rr, Rp^Vhc, Rp, Rr, Rr, Rp, Gs, Rr, Rp^Vhc, Wo, Wo, Wo, Wo, Wo, Ww, Wo, Ww, Wo, Wo, Ww, Ww, Ww, Ww, Gg^Vl, Ur, Ur, Qlf, Uh, Uh, Ql, Ql, Uh, Mm, Gs^Ft, Gs^Ft, Ww, Ww, Wwr, Wwr, Wo, Wo, Wo
Wo, Wo, Wo, Wo, Wo, Wo, Wo, Wwr, Wwr, Ww, Ww, Ww, Wo, Ww, Ww, Ww, Ww, Wo, Ww, Ww, Ww, Ds, Ds, Gs^Ft, Gs^Ft, Gs^Ft, Gs, Gg, Wwf, Wo, Ww, Ww, Ww, Wo, Ww, Rd, Rd, Gs^Ft, Rp^Vhc, Hh^Fds, Rp, Hh, Mm, Gs^Fms, Hh, Re^Gvs, Re^Gvs, Gg^Efm, Rr, Gg, Wo, Wo, Wo, Ww, Ww, Ww, Ww, Wo, Wo, Wo, Ww, Ww, Wo, Ur, Ur, Qlf, Ww, Mm, Gs^Ft, Qlf, Qlf, Ql, Qlf, Mm, Rd, Rd, Ww, Wwr, Ww, Wo, Wo, Wo
Wo, Wo, Wo, Wo, Wo, Wo, Wo, Wwr, Wwr, Ww, Ww, Ww, Ww, Ww, Ww, Ww, Ww, Wo, Wo, Ww, Wo, Ww, Ww, Gg, Ds, Gs, Re^Gvs, Re^Gvs, Gg^Vh, Wo, Wo, Ww, Wo, Ww, Ww, Gg^Efm, Gs^Fms, Rr, Gs^Ft, Rp, Re^Gvs, Hh, Mm, Mm, Mm, Hh^Fds, Hh, Re^Gvs, Re^Gvs, Rp, Rp, Wo, Wo, Wo, Wo, Wo, Wo, Ww, Wo, Wo, Wo, Wo, Wo, Wo, Wo, Ww, Ww, Gs^Ft, Ww, Ur, Mm, Ql, Qlf, Uh, Gs^Ft, Rd, Ww, Ww, Ww, Wo, Wo, Wo
Wo, Wo, Wo, Wo, Wo, Wo, Wwr, Wwr, Wo, Wo, Wo, Ww, Ww, Ww, Ww, Ww, Ww, Wo, Wo, Wo, Wo, Ww, Ww, Ww, Ww, Ww, Ww, Re^Gvs, Gg^Efm, Ds, Wo, Ww, Wwr, Wo, Ww, Ww, Gs, Gs^Fms, Gs^Fms, Re^Gvs, Gs^Ft, Hh, Gs^Fds, Mm, Mm^Xm, Mm, Mm, Re^Gvs, Gs^Ft, Mm, Hh, Rr, Rp^Vhc, Wo, Wo, Wo, Wo, Wo, Wo, Wo, Wo, Wwr, Wwr, Wo, Wo, Wo, Wo, Ww, Ww, Gs^Ft, Mm, Uh, Mm, Mm, Gs^Ft, Ww, Ww, Ww, Wo, Wo, Wo, Wo
Wo, Wo, Wo, Wo, Wo, Wo, Wo, Wo, Wo, Wo, Wo, Wo, Ww, Ww, Ww, Ww, Ww, Wo, Wo, Wo, Wo, Wo, Wo, Wo, Wo, Ww, Wo, Ww, Ww, Ww, Wo, Wo, Wwr, Wwr, Wwr, Ww, Ww, Gs, Gs, Gs^Ft, Gs^Ft, Gs^Ft, Mm, Mm, Mm^Xm, Aa^Fma, Mm, Re^Gvs, Gs^Ft, Mm, Mm, Rp, Gg, Wo, Wo, Wo, Ww, Ww, Ww, Wo, Ww, Wo, Wwr, Wo, Ww, Wo, Wo, Wo, Wo, Ww, Ww, Mm, Mm, Gs^Ft, Mm, Ww, Ww, Ww, Ww, Wo, Wo, Wo
Wo, Wo, Wo, Wo, Wo, Wo, Wo, Wo, Wo, Wo, Wo, Wo, Ww, Ww, Ww, Ww, Ww, Wo, Wo, Ww, Ww, Ww, Wo, Wo, Wo, Wo, Wo, Wo, Wo, Ww, Wo, Wo, Wo, Wwr, Ww, Ww, Ww, Gg, Gs^Ft, Gs^Fds, Gs^Ft, Hh^Fdf, Gg, Mm^Xm, Mm, Mm^Xm, Hh^Fdf, Hh, Gs^Fds, Mm, Rp, Rp, Gg^Efm, Wo, Wo, Wo, Wo, Wo, Wo, Ww, Wo, Wwr, Wwr, Ww, Ww, Wo, Wo, Ww, Ww, Wo, Gs^Ft, Mm, Uh, Mm, Uh, Mm, Gs, Ww, Ww, Ww, Ww, Wo
Wo, Wo, Wo, Wo, Wo, Wo, Wo, Wo, Wo, Wo, Wo, Wo, Ww, Wo, Wo, Wo, Wo, Wo, Ww, Ww, Ww, Ww, Ww, Wo, Ww, Wo, Wo, Wo, Wwr, Wo, Ww, Wo, Wo, Wo, Ww, Ww, Ww, Ww, Gg^Vc, Gs^Ft, Gs^Fds, Hh, Gs^Ft, Hh^Vc, Mm, Mm, Mm^Xm, Gs^Fds, Hh, Rp^Vhc, Gs^Ft, Re^Gvs, Gs, Wo, Wo, Wo, Wo, Wo, Wo, Wo, Wo, Wo, Wo, Ww, Ww, Wo, Wo, Ww, Wo, Wo, Gs^Ft, Mm, Qlf, Ql, Uh, Mm, Gs^Ft, Wo, Ww, Ww, Wo, Wo
Wo, Wo, Wo, Wo, Wo, Wo, Wo, Wo, Wo, Wo, Wo, Wo, Wo, Wo, Wo, Wo, Wo, Ww, Ww, Wo, Ww, Ww, Wo, Wo, Wo, Ww, Ww, Ww, Wwr, Ww, Ww, Ww, Wo, Wo, Wo, Wo, Wo, Wo, Wo, Gs^Ft, Gs^Fds, Gg^Fet, Hh, Gs, Hh^Fms, Mm, Mm, Mm, Mm, Gs^Ft, Gs^Ft, Re^Gvs, Ww, Ww, Ww, Ww, Wo, Wo, Ss, Ss, Ss, Wo, Wo, Wo, Wo, Wo, Ww, Wo, Ww, Ww, Ur, Mm, Qlf, Uh, Mm, Mm, Mm, Gs, Ww, Wo, Wo, Wo
Wo, Wo, Wo, Wo, Wo, Wo, Wo, Wo, Wo, Wo, Wo, Wo, Wo, Wo, Wo, Wo, Wo, Wwr, Wwr, Wo, Wo, Wo, Wo, Wo, Wo, Wo, Ww, Wwr, Wwr, Wwr, Wwr, Wo, Wwr, Wo, Ww, Ww, Ww, Ww, Wo, Gg, Gs^Ft, Gs^Ft, Gs^Ft, Hh^Fds, Gs^Ft, Hh, Hh^Fms, Mm^Xm, Hh, Gs^Ft, Re^Gvs, Re^Gvs, Ww, Ww, Ww, Wo, Wo, Ss, Gs^Ft, Gg, Ww, Ww, Wo, Wo, Wo, Ww, Gs^Vl, Ww, Ww, Ww, Ww, Qlf, Qlf, Mm, Gs^Ft, Gs^Ft, Ww, Gs^Ft, Ww, Ww, Wo, Wo
Wo, Wo, Wo, Wo, Wo, Wo, Wo, Wo, Wo, Wo, Wo, Wo, Wo, Wo, Wo, Wo, Wo, Wwr, Wwr, Wwr, Wo, Wo, Wo, Wo, Wo, Ww, Ww, Wo, Wwr, Wwr, Wo, Wwr, Wo, Wo, Wo, Wo, Ww, Ww, Wo, Wo, Ww, Gs, Ww, Gs^Fms, Hh^Fds, Gs, Mm, Mm, Hh, Re^Gvs, Wwf, Ww, Ww, Wo, Wo, Wo, Wo, Ss, Gg, Gg^Vud, Gg, Ww, Ss, Wo, Wo, Wo, Re^Gvs, Gs^Ft, Re^Gvs, Re^Gvs, Re^Gvs, Ww, Ww, Ur, Gs^Ft, Wo, Wo, Ww, Ww, Ww, Wo, Wo
Wo, Wo, Wo, Wo, Wo, Wo, Wo, Wo, Wo, Wo, Wo, Wo, Wo, Wo, Wo, Wo, Wo, Wo, Wo, Wwr, Wo, Wo, Wo, Wo, Wo, Wo, Ww, Wo, Wo, Wo, Wo, Wwr, Wo, Wo, Wwr, Wo, Ww, Ww, Ww, Wo, Wo, Ww, Ww, Ww, Wwf, Wwf, Ww, Mm, Wwf, Wwf, Gs^Ft, Ww, Ww, Wo, Wo, Ww, Ww, Gs^Ft, Wo, Ww, Gs^Ft, Gs^Ft, Ss, Wo, Wo, Ww, Ww, Re^Gvs, Re^Gvs, Mm, Gs^Ft, Re^Gvs, Re^Gvs, Ww, Wo, Wo, Ww, Wo, Wo, Wo, Wo, Wo
Wo, Wo, Wo, Wo, Wo, Wo, Wo, Wo, Wo, Wo, Wo, Wo, Wo, Wo, Wo, Wo, Wo, Wo, Wo, Wo, Wo, Wo, Wo, Wo, Wo, Wo, Wo, Ww, Wo, Wo, Wo, Wo, Wo, Wo, Ww, Ww, Wwr, Wwr, Wo, Wo, Ww, Ww, Gs, Gs, Gs^Ft, Hh^Fds, Gs, Ww, Gs^Ft, Gs^Ft, Gs, Gg, Wo, Wo, Wo, Wo, Wo, Wo, Ww, Wo, Ss, Ss, Ss, Wo, Wo, Ww, Ww, Re^Gvs, Gs^Vl, Gs^Ft, Mm, Gs^Ft, Gs^Ft, Ww, Wo, Ww, Ww, Ww, Ww, Wo, Wo, Wo
Wo, Wo, Wo, Wo, Wo, Wo, Wo, Wo, Wo, Wwr, Wo, Wo, Ww, Ww, Ww, Ww, Wo, Wo, Wo, Wo, Wo, Wo, Wo, Wo, Wo, Wo, Wo, Wo, Wo, Wo, Wo, Wo, Wo, Wo, Ww, Wwr, Wwr, Ww, Wo, Wo, Wo, Ww, Gg, Gs^Ft, Gs^Fds, Gs^Ft, Gs^Fds, Gg^Vc, Gs^Ft, Gs^Ft, Gs^Fds, Gs, Ww, Wo, Ww, Ww, Wo, Wo, Ww, Wo, Wo, Ww, Wo, Wo, Ww, Ww, Ww, Re^Gvs, Gs^Ft, Gs^Ft, Mm, Mm, Mm, Ww, Wo, Wo, Ww, Ww, Ww, Wo, Wo, Wo
Wo, Wo, Wo, Wo, Wo, Wo, Wo, Wo, Wwr, Wwr, Wwr, Wwr, Wwr, Ww, Ww, Wwr, Wo, Wo, Wo, Wo, Wo, Wo, Wo, Wo, Wo, Wo, Wo, Wo, Wo, Wo, Wo, Wo, Wo, Wo, Wo, Ww, Wo, Wo, Wo, Wo, Wo, Ww, Ww, Gs^Ft, Gs, Gs^Fds, Gs^Ft, Hh, Mm, Hh, Hh, Gg, Gg^Vc, Ww, Gs^Ft, Ww, Gs^Ft, Wo, Ww, Ww, Wo, Wo, Wo, Wo, Wo, Ww, Gs^Ft, Gs, Ur, Uh, Ql, Uh, Hh, Ww, Ww, Wo, Ww, Ww, Wo, Wo, Wo, Wo
Wo, Wo, Wo, Wo, Wo, Wo, Wo, Wo, Wo, Wo, Ww, Ww, Ww, Ww, Ww, Wo, Wo, Wo, Wo, Wo, Wo, Wo, Wo, Wo, Wo, Wo, Wo, Wo, Wo, Wo, Wo, Wo, Wo, Wo, Wo, Wo, Wo, Wo, Wo, Wo, Wo, Ww, Ww, Ww, Wo, Gs^Fds, Gs^Ft, Hh, Hh^Fms, Mm, Mm^Xm, Gg, Hh, Hh, Mm^Xm, Hh^Fms, Hh, Ww, Ww, Wo, Wwr, Wo, Wo, Wo, Wo, Wo, Gs^Ft, Uh, Qlf, Qlf, Qlf, Uh, Gs^Ft, Gs^Ft, Ww, Wo, Ww, Ww, Wo, Wo, Wo, Wo
Wo, Wo, Wo, Wo, Wo, Wo, Wo, Wo, Wo, Wo, Ww, Ww, Wo, Wo, Wo, Wo, Wo, Wo, Wo, Wo, Wo, Wo, Wo, Wo, Wo, Wo, Wo, Wo, Wo, Wo, Wo, Wo, Wo, Wo, Wo, Wo, Wo, Wo, Wo, Wo, Wo, Ww, Ww, Ww, Ww, Gs, Gg^Fet, Hh, Hh^Fms, Mm, Mm, Mm, Mm^Xm, Mm^Xm, Mm, Mm, Gs^Fms, Gs^Ft, Ww, Ww, Ww, Wwr, Ww, Wo, Wo, Wo, Gs^Ft, Uh, Qlf, Mm, Ql, Uh, Ww, Ww, Wo, Wo, Ww, Wo, Wo, Wo, Wo, Wo
Wo, Wo, Wo, Wo, Wo, Wo, Wo, Wo, Wo, Wo, Ww, Ww, Wo, Wo, Wo, Wo, Wo, Wo, Wo, Wo, Wo, Wo, Wo, Wo, Wo, Wo, Wo, Wo, Wo, Wo, Wo, Wo, Wo, Wo, Wo, Wo, Wo, Wo, Wo, Wo, Wo, Wo, Ww, Ww, Ww, Gs, Gg^Efm, Gs^Ft, Hh^Fdf, Gg, Gg^Vc, Mm^Xm, Gs^Fds, Hh, Gg^Efm, Gg^Vc, Gs^Fms, Gs^Ft, Ww, Gs^Fms, Gs^Ft, Wwr, Wwr, Wo, Ww, Ww, Ww, Ur, Ww, Qlf, Ur, Hh, Ww, Wo, Wo, Ww, Wo, Wo, Wo, Wo, Wo, Wo
Wo, Wo, Wo, Wo, Wo, Wo, Wo, Wo, Wo, Wo, Wo, Wo, Wo, Wo, Wo, Wo, Wo, Wo, Wo, Wo, Wo, Wo, Wo, Wo, Wo, Wo, Wo, Wwr, Wo, Wo, Wo, Wo, Wo, Wo, Wo, Wo, Wo, Wo, Wo, Wo, Wo, Wo, Wo, Wo, Wo, Ww, Ww, Gs^Ft, Gs^Fds, Gs, Hh, Hh^Fms, Gg^Fet, Gs^Ft, Wo, Wo, Wo, Ww, Wo, Wo, Wwr, Wwr, Wwr, Wo, Wo, Ww, Ww, Ww, Gs^Ft, Ur, Mm, Ww, Wo, Wo, Wo, Wo, Wo, Wo, Wo, Wo, Wo, Wo
Wo, Wo, Wo, Wo, Wo, Wo, Wo, Wo, Wo, Wo, Wo, Wo, Wo, Wo, Wo, Wo, Wo, Wo, Wo, Wo, Wwr, Wo, Wo, Wo, Wo, Wo, Wo, Wo, Wo, Wo, Wo, Wo, Wo, Wo, Wo, Wo, Wo, Wo, Wo, Wo, Wo, Wo, Wo, Wo, Ww, Ww, Ww, Gg^Efm, Gs^Ft, Gs^Ft, Gs^Ft, Gs^Fds, Wo, Wo, Ww, Wo, Wo, Wo, Wo, Wo, Ww, Wwr, Ww, Ww, Wo, Wo, Ww, Gs^Ft, Hh, Mm, Ww, Ww, Wo, Ww, Ww, Ww, Ww, Wo, Wo, Wo, Wo, Wo
Wo, Wo, Wo, Wo, Wo, Wo, Wo, Wo, Wo, Wo, Wo, Wo, Wo, Wo, Wo, Wo, Wo, Wo, Wwr, Wwr, Wwr, Wo, Wo, Wo, Ww, Ww, Ww, Wo, Wo, Wo, Wo, Wo, Wo, Wo, Wo, Wo, Ww, Ww, Ww, Wo, Wo, Wo, Wwr, Wo, Wo, Ww, Wo, Wo, Wo, Wo, Ww, Ww, Ww, Wo, Ww, Ww, Ww, Wwr, Wwr, Wo, Wo, Ww, Ww, Ww, Wo, Wo, Wo, Wo, Wo, Wo, Wo, Wo, Wo, Wo, Wo, Ww, Ww, Ww, Wo, Wo, Wo, Wo
Wo, Wo, Wo, Wo, Wo, Wo, Wo, Wo, Wo, Wo, Wo, Wo, Wo, Wo, Wo, Wo, Wo, Wo, Wwr, Wo, Wo, Wo, Wo, Ww, Ww, Ww, Ww, Wo, Wo, Wo, Wo, Wo, Wo, Wo, Wo, Wo, Ww, Ww, Wo, Wo, Wo, Wo, Wo, Wo, Wo, Wo, Wo, Wo, Wo, Ww, Wo, Ww, Wo, Wo, Wwr, Ww, Ww, Ww, Wwr, Wwr, Wwr, Wwr, Wo, Wo, Wo, Wo, Ww, Ww, Ww, Wo, Wo, Wo, Wo, Wo, Gg, Wo, Wo, Wo, Wo, Wo, Wo, Wo
Wo, Wo, Wo, Wo, Wo, Wo, Wo, Wo, Wo, Wo, Ww, Wo, Wo, Wo, Wo, Wo, Wo, Wo, Wwr, Wwr, Wo, Wo, Wo, Wo, Wo, Wo, Wo, Wo, Wo, Wo, Wo, Wo, Wo, Wo, Wo, Wo, Wo, Wo, Wo, Wo, Wo, Wo, Wo, Wwr, Wwr, Wo, Wo, Wo, Wo, Wo, Ww, Ww, Wo, Wo, Ww, Ww, Wwr, Ww, Wwr, Wwr, Gs^Ft, Wo, Wo, Gs^Ft, Wo, Wo, Wo, Ww, Wo, Ww, Ww, Ww, Wo, Wo, Gs^Ft, Gs^Ft, Wo, Wo, Ww, Wo, Wo, Wo
Wo, Wo, Wo, Wo, Wo, Wo, Wwr, Wo, Wo, Wo, Wo, Ww, Ww, Wo, Wo, Wo, Wo, Wo, Wo, Wo, Wo, Wo, Wo, Wo, Wo, Wo, Wo, Wo, Wo, Wo, Ww, Wo, Ww, Wo, Wo, Wo, Wo, Wo, Wo, Wo, Wo, Wo, Wo, Wo, Wo, Wo, Wo, Wo, Wo, Wo, Wo, Ww, Wo, Wwr, Wwr, Wwr, Wwr, Wo, Wo, Wo, Mm, Mm, Mm, Gs^Ft, Gs^Ft, Ss, Ss, Ww, Ww, Ww, Ww, Ww, Ww, Gs^Ft, Mm, Mm, Ww, Ww, Ww, Ww, Wo, Wo
Wo, Wo, Wwr, Wo, Wo, Wwr, Wwr, Wo, Wo, Wo, Wo, Ww, Ww, Wo, Wo, Wo, Wo, Wo, Wo, Wo, Wo, Wo, Wo, Wo, Wo, Wo, Wo, Wo, Wo, Wo, Wo, Wo, Wo, Wo, Wo, Wo, Wo, Wo, Wo, Wo, Wo, Wo, Wo, Wo, Wo, Wo, Wo, Wwr, Wo, Wo, Wo, Wo, Wo, Wwr, Wo, Wwr, Wo, Wo, Wo, Wo, Wo, Wo, Ww, Gs^Ft, Ss, Ss, Ww, Ww, Gs^Ft, Ww, Ww, Ww, Ww, Wo, Gs^Ft, Ww, Ww, Ww, Ww, Ww, Wo, Wo
Wo, Wo, Wo, Wwr, Wwr, Wwr, Wo, Ww, Wo, Wo, Wo, Wo, Wo, Wo, Wo, Wo, Wo, Wo, Wo, Wo, Wo, Wo, Wo, Wo, Wo, Wo, Wwr, Wo, Wwr, Wo, Wwr, Wo, Wo, Wo, Wo, Wo, Wo, Wo, Wo, Wo, Wo, Wo, Wo, Wo, Wo, Wo, Wwr, Wwr, Wwr, Wwr, Wo, Wo, Wo, Wo, Wo, Wo, Wo, Wo, Ww, Wo, Ww, Wo, Wo, Ww, Ww, Ss, Ss, Gg, Gs^Ft, Gs^Ft, Gs^Ft, Gg, Gs^Ft, Ww, Ss, Gg, Ww, Ss, Ww, Wo, Wo, Wo
Wo, Wo, Wo, Wo, Wo, Ww, Wo, Wo, Ww, Ww, Ww, Wo, Wo, Wo, Wo, Wo, Wo, Wo, Wo, Wo, Wo, Wo, Wo, Wo, Wo, Wo, Wo, Wwr, Wwr, Wwr, Wo, Wo, Wo, Wo, Wo, Wo, Wo, Wo, Wo, Wo, Wo, Wo, Wo, Wo, Wo, Wo, Wo, Wwr, Wwr, Ww, Ww, Wo, Wo, Wo, Ww, Wo, Wo, Ww, Ww, Ww, Ww, Wo, Wo, Wo, Wo, Wo, Ss, Ss, Gs^Ft, Mm, Gs^Ft, Ww, Ww, Gs^Ft, Ss, Ss, Ss, Ss, Wo, Wo, Wo, Wo
Wo, Wo, Wo, Wo, Wo, Wo, Wo, Ww, Wo, Wo, Wo, Wo, Wo, Wo, Wo, Wo, Wo, Wo, Wo, Wo, Wo, Wo, Wo, Wo, Wo, Wo, Wo, Wo, Ww, Wo, Wo, Wo, Wo, Wo, Wo, Wo, Wo, Wo, Wo, Wo, Wwr, Wo, Wo, Wo, Wo, Wwr, Wwr, Wwr, Ww, Ww, Ww, Wo, Wo, Wo, Wo, Ww, Ww, Wo, Ww, Ww, Wo, Wo, Wo, Ww, Ww, Wo, Ww, Ss, Ww, Ww, Ww, Ww, Wo, Wo, Ss, Ss, Gs^Ft, Ss, Gs^Ft, Ww, Ww, Wo
Wo, Wo, Wo, Wo, Wo, Wo, Wo, Wo, Wo, Wo, Wo, Wo, Wo, Wo, Wo, Wo, Wo, Wo, Wo, Wo, Wo, Wo, Wo, Wo, Wo, Ww, Wo, Ww, Wo, Wo, Wo, Wo, Wo, Wo, Wo, Wo, Wo, Wo, Wo, Wo, Wo, Wwr, Wwr, Wo, Wo, Wo, Ww, Ww, Wo, Ww, Wo, Wo, Wo, Wo, Wo, Ww, Wo, Ww, Wo, Wo, Wo, Wo, Ww, Ww, Ww, Ww, Wo, Ww, Ww, Ww, Wo, Wo, Ww, Wo, Wo, Gs^Ft, Mm, Mm, Mm, Gs^Ft, Ww, Ww
Wo, Wo, Wo, Wo, Wo, Wo, Wo, Wo, Wo, Wo, Wo, Wo, Wo, Wo, Wo, Wo, Wo, Wo, Wo, Wo, Wo, Wo, Wo, Wo, Wo, Wo, Wo, Wo, Wo, Wo, Wo, Wo, Wo, Wo, Wo, Wo, Wo, Wo, Wo, Wo, Wo, Wwr, Wo, Wo, Wo, Wo, Wo, Wo, Wo, Wo, Wo, Wo, Wo, Wo, Wo, Wo, Wo, Wo, Wo, Wo, Wo, Wo, Wo, Wo, Wo, Wo, Wo, Ww, Wo, Ww, Wo, Wo, Ww, Ww, Ww, Wo, Wo, Ww, Ww, Ww, Gs^Ft, Gs^Ft
Xv, Xv, Xv, Xv, Xv, Xv, Xv, Xv, Xv, Xv, Xv, Xv, Xv, Xv, Xv, Xv, Xv, Xv, Xv, Xv, Xv, Xv, Xv, Xv, Xv, Xv, Xv, Xv, Xv, Xv, Xv, Xv, Xv, Xv, Xv, Xv, Xv, Xv, Xv, Xv, Xv, Xv, Xv, Xv, Xv, Xv, Xv, Xv, Xv, Xv, Xv, Xv, Xv, Xv, Xv, Xv, Xv, Xv, Xv, Xv, Xv, Xv, Xv, Xv, Xv, Xv, Xv, Xv, Xv, Xv, Xv, Xv, Xv, Xv, Xv, Xv, Xv, Xv, Xv, Xv, Xv, Gs^Ft
Xv, Xv, Xv, Xv, Xv, Xv, Xv, Xv, Xv, Xv, Xv, Xv, Xv, Xv, Xv, Xv, Xv, Xv, Xv, Xv, Xv, Xv, Xv, Xv, Xv, Xv, Xv, Xv, Xv, Xv, Xv, Xv, Xv, Xv, Xv, Xv, Xv, Xv, Xv, Xv, Xv, Xv, Xv, Xv, Xv, Xv, Xv, Xv, Xv, Xv, Xv, Xv, Xv, Xv, Xv, Xv, Xv, Xv, Xv, Xv, Xv, Xv, Xv, Xv, Xv, Xv, Xv, Xv, Xv, Xv, Xv, Xv, Xv, Xv, Xv, Xv, Xv, Xv, Xv, Xv, Xv, Xv
Xv, Xv, Xv, Xv, Xv, Xv, Xv, Xv, Xv, Xv, Xv, Xv, Xv, Xv, Xv, Xv, Xv, Xv, Xv, Xv, Xv, Xv, Xv, Xv, Xv, Xv, Xv, Xv, Xv, Xv, Xv, Xv, Xv, Xv, Xv, Xv, Xv, Xv, Xv, Xv, Xv, Xv, Xv, Xv, Xv, Xv, Xv, Xv, Xv, Xv, Xv, Xv, Xv, Xv, Xv, Xv, Xv, Xv, Xv, Xv, Xv, Xv, Xv, Xv, Xv, Xv, Xv, Xv, Xv, 1 Xv, Xv, Xv, 2 Xv, Xv, Xv, Xv, Xv, Xv, Xv, Xv, Xv, Xv
Xv, Xv, Xv, Xv, Xv, Xv, Xv, Xv, Xv, Xv, Xv, Xv, Xv, Xv, Xv, Xv, Xv, Xv, Xv, Xv, Xv, Xv, Xv, Xv, Xv, Xv, Xv, Xv, Xv, Xv, Xv, Xv, Xv, Xv, Xv, Xv, Xv, Xv, Xv, Xv, Xv, Xv, Xv, Xv, Xv, Xv, Xv, Xv, Xv, Xv, Xv, Xv, Xv, Xv, Xv, Xv, Xv, Xv, Xv, Xv, Xv, Xv, Xv, Xv, Xv, Xv, Xv, Xv, Xv, Xv, Xv, Xv, Xv, Xv, Xv, 3 Xv, Xv, Xv, Xv, Xv, Xv, Xv
Xv, Xv, Xv, Xv, Xv, Xv, Xv, Xv, Xv, Xv, Xv, Xv, Xv, Xv, Xv, Xv, Xv, Xv, Xv, Xv, Xv, Xv, Xv, Xv, Xv, Xv, Xv, Xv, Xv, Xv, Xv, Xv, Xv, Xv, Xv, Xv, Xv, Xv, Xv, Xv, Xv, Xv, Xv, Xv, Xv, Xv, Xv, Xv, Xv, Xv, Xv, Xv, Xv, Xv, Xv, Xv, Xv, Xv, Xv, Xv, Xv, Xv, Xv, Xv, Xv, Xv, Xv, 6 Xv, Xv, Xv, 5 Xv, Xv, Xv, Xv, Xv, Xv, Xv, Xv, Xv, Xv, Xv, Xv
Xv, Xv, Xv, Xv, Xv, Xv, Xv, Xv, Xv, Xv, Xv, Xv, Xv, Xv, Xv, Xv, Xv, Xv, Xv, Xv, Xv, Xv, Xv, Xv, Xv, Xv, Xv, Xv, Xv, Xv, Xv, Xv, Xv, Xv, Xv, Xv, Xv, Xv, Xv, Xv, Xv, Xv, Xv, Xv, Xv, Xv, Xv, Xv, Xv, Xv, Xv, Xv, Xv, Xv, Xv, Xv, Xv, Xv, Xv, Xv, Xv, Xv, Xv, Xv, Xv, Xv, Xv, Xv, Xv, Xv, Xv, Xv, Xv, 4 Xv, Xv, Xv, Xv, Xv, Xv, Xv, Xv, Xv
Xv, Xv, Xv, Xv, Xv, Xv, Xv, Xv, Xv, Xv, Xv, Xv, Xv, Xv, Xv, Xv, Xv, Xv, Xv, Xv, Xv, Xv, Xv, Xv, Xv, Xv, Xv, Xv, Xv, Xv, Xv, Xv, Xv, Xv, Xv, Xv, Xv, Xv, Xv, Xv, Xv, Xv, Xv, Xv, Xv, Xv, Xv, Xv, Xv, Xv, Xv, Xv, Xv, Xv, Xv, Xv, Xv, Xv, Xv, Xv, Xv, Xv, Xv, Xv, Xv, Xv, Xv, Xv, Xv, Xv, Xv, Xv, Xv, Xv, Xv, Xv, Xv, Xv, Xv, Xv, Xv, Xv
Xv, Xv, Xv, Xv, Xv, Xv, Xv, Xv, Xv, Xv, Xv, Xv, Xv, Xv, Xv, Xv, Xv, Xv, Xv, Xv, Xv, Xv, Xv, Xv, Xv, Xv, Xv, Xv, Xv, Xv, Xv, Xv, Xv, Xv, Xv, Xv, Xv, Xv, Xv, Xv, Xv, Xv, Xv, Xv, Xv, Xv, Xv, Xv, Xv, Xv, Xv, Xv, Xv, Xv, Xv, Xv, Xv, Xv, Xv, Xv, Xv, Xv, Xv, Xv, Xv, Xv, Xv, Xv, Xv, Xv, Xv, Xv, Xv, Xv, Xv, Xv, Xv, Xv, Xv, Xv, Xv, Xv
