Md^Xm, Md^Xm, Md^Xm, Md^Xm, Md^Xm, Md^Xm, Md, Md, Md, Md, Hd, Hd, Hd, Re, Re, Re, Re, Re, Re, Re, Gs^Fdf, Gs^Fdf, Re, Gs^Fdf, Gs^Fdf, Gs^Fdf, Ww, Hh, Hh, Hh, Md^Xm, Gs^Fdf, Gs^Fdf, Gs^Fdf, Gs^Fdf, Gs^Fdf, Hh, Md^Xm, Md, Md^Xm, Hd, Hd, Hd, Md, Md, Md, Md^Xm, Md^Xm, Md^Xm, Md^Xm, Md^Xm, Md^Xm, Md^Xm
Md^Xm, Md^Xm, Md^Xm, Md^Xm, Md, Md, Md, Md, Hd, Hd, Rd, Rd, Re, Re, Gs^Fdf, Re, Re, Re, Hh, Hh, Hh, Gs^Fdf, Gs^Fdf, Gs^Fdf, Gs^Fdf, Md^Xm, Ww, Hh, Hh^Fdf, Hh^Fdf, Gs^Fdf, Gs^Fdf, Re, Gs^Fdf, Re, Gs^Fdf, Gs^Fdf, Hh, Md^Xm, Hh, Hh, Hd, Hd, Md, Md, Md, Md, Md, Md, Md^Xm, Md^Xm, Md^Xm, Md^Xm
Md^Xm, Md^Xm, Md, Md, Hd, Hd, Hd, Hd, Gs^Fdf, Re, Re, Gg^Ve, Re, Re, Re, Re, Re, Re, Hh^Fdf, Hh, Gs^Fdf, Gs^Fdf, Re, Gs^Fdf, Re, Re, Ww, Re, Re, Hh^Fdf, Hh, Re, Gs^Fdf, Gs^Fdf, Re, Gs^Fdf, Gs^Fdf, Hh, Md^Xm, Md^Xm, Re, Gs^Fdf, Re, Re, Re, Md, Rd, Hd, Hd, Md, Md^Xm, Md^Xm, Md^Xm
Md, Md, Md, Hd, Gs^Fdf, Gs^Fdf, Re, Gs^Fdf, Re, Re, Re, Re, Gs^Fdf, Re, Re, Re, Re, Hh^Fdf, Hh^Fdf, Hh^Fdf, Hh, Rd, Rd, Re, Re, Re, Ww, Re, Re, Re, Re, Hh, Re, Re, Re, Re, Re, Hh, Md^Xm, Gs^Fdf, Re, Gg^Vc, Re, Re, Gs^Fdf, Re, Rd, Rd, Hh, Md, Md, Md, Md
Md, Md, Md, Hd, Re, Re, Gg^Ve, Re, Re, Re, Gs^Fdf, Gs^Fdf, Gs^Fdf, Gs^Fdf, Hh^Fdf, Hh, Re, Re, Re, Hh, Re, Gg^Vh, Re, Re, Re, Hh^Fdf, Ww, Gg^Vh, Re, Re, Re, Rd, Gg^Vh, Re, Re, Re, Hh, Hh, Md^Xm, Gs^Fdf, Re, Re, Re, Hh, Gs^Fdf, Re, Re, Gg^Vc, Re, Rd, Md, Md, Md
Md, Md, Hd, Hd, Gs^Fdf, Re, Re, Re, Re, Gs^Fdf, Gs^Fdf, Gs^Fdf, Md^Xm, Gs^Fdf, Hh, Hh, Re, Re, Re, Re, Re, Re, Gs^Fdf, Re, Hh^Fdf, Hh, Ww, Re, Re, Re, Hh, Re, Re, Re, Re, Re, Hh, Md^Xm, Md^Xm, Hh, Re, Re, Re, Gs^Fdf, Re, Re, Hh^Fdf, Re, Hd, Gs^Fdf, Md, Md, Hd
Hd, Hd, Md^Xm, Hd, Re, Re, Gs^Fdf, Re, Re, Re, Rd, Gs^Fdf, Md^Xm, Md^Xm, Gs^Fdf, Gs^Fdf, Re, Re, Re, Gs^Fdf, Re, Hh, Gs^Fdf, Re, Re, Hh, Ww^Bw/, Re, Hh, Hh^Fdf, Re, Re, Re, Re, Re, Re, Gs^Fdf, Hh, Md^Xm, Hh, Gs^Fdf, Re, Re, Rd, Rd, Re, Re, Md, Hh^Fdf, Hd, Hd, Hd, Hd
Hh, Hd, Md^Xm, Md^Xm, Md^Xm, Re, Re, Re, Re, Gs^Fdf, Re, Gs^Fdf, Gs^Fdf, Md^Xm, Gs^Fdf, Gs^Fdf, Re, Re, Re, Re, Re, Re, Gg^Vh, Re, Re, Re, Ww, Re, Re, Hh, Gg^Vh, Re, Re, Md^Xm, Rd, Re, Re, Md^Xm, Md^Xm, Hh, Re, Re, Re, Re, Hh^Fdf, Re, Hh^Fdf, Re, Re, Hd, Gg^Fet, Hd, Hd
Hh, Hh, Hh, Md^Xm, Md^Xm, Md^Xm, Hh^Fdf, Re, Re, Rd, Gg^Ve, Re, Gs^Fdf, Md^Xm, Md^Xm, Gs^Fdf, Rd, Re, Gg^Vh, Re, Re, Re, Re, Rd, Hh^Fdf, Hh^Fdf, Ww, Re, Re, Re, Re, Re, Re, Re, Re, Gg^Vh, Re, Hh, Hh, Gs^Fdf, Re, Re, Gg^Vc, Re, Re, Hh^Fdf, Md^Xm, Mm, Re, Re, Gg^Ve, Hd, Re
Hh, Hh, Gs^Fdf, Gs^Fdf, Md^Xm, Md^Xm, Md^Xm, Re, Re, Re, Gs^Fdf, Re, Gs^Fdf, Md^Xm, Md^Xm, Hh, Re, Re, Re, Re, Re, Re, Re, Re, Rd, Re, Ww, Re, Hh^Fdf, Re, Re, Re, Hh^Fdf, Hh^Fdf, Re, Re, Re, Gs^Fdf, Gs^Fdf, Gs^Fdf, Re, Hh, Re, Re, Hh, Md^Xm, Hd, Re, Gs^Fdf, Re, Hh, Re, Re
Hh, Re, Re, Re, Re, Md^Xm, Md^Xm, Md^Xm, Hh, Re, Re, Re, Hh^Fdf, Hh^Fdf, Gs^Fdf, Md^Xm, Hh, Re, Re, Re, Hh, Re, Hh, Hh^Fdf, Re, Gg^Vh, Ww, Re, Re, Re, Hh, Hh, Hh^Fdf, Hh^Fdf, Re, Re, Re, Re, Re, Re, Re, Re, Hh, Hh, Md^Xm, Md^Xm, Re, Re, Gs^Fdf, Re, Re, Gs^Fdf, Re
Re, Re, Re, Gg^Vc, Hh, Re, Hh, Md^Xm, Hh, Re, Re, Re, Re, Hh^Fdf, Gs^Fdf, Gs^Fdf, Gs^Fdf, Hh, Re, Re, Re, Re, Hh, Gs^Fdf, Ds, Re, Ww, Re, Ds, Hh, Hh^Fdf, Hh^Fdf, Re, Hh, Re, Re, Hh^Fdf, Re, Re, Re, Re, Re, Md^Xm, Md^Xm, Md^Xm, Re, Re, Re, Re, Re, Re, Re, Re
Re, Re, Hh^Fdf, Re, Re, Re, Re, Hh, Re, Re, Re, Re, Re, Re, Re, Re, Re, Re, Re, Gg^Fet, Re, Re, Ds, Ds, Wwf, Wwr, Wwr, Wwr, Wwf, Ds, Ds, Re, Re, Re, Re, Gs^Fdf, Re, Gs^Fdf, Re, Re, Hh^Fdf, Md^Xm, Md^Xm, Md^Xm, Gs^Fdf, Re, Re, Gg^Ve, Re, Rd, Re, Gs^Fdf, Gs^Fdf
Re, Hh^Fdf, Hh^Fdf, Re, Re, Re, Re, Re, Gg^Vc, Re, Re, Re, Hh, Re, Re, Re, Hh^Fdf, Re, Re, Re, Ds, Ds, Ds, Wwf, Ww, Wwf, Ss, Wwf, Ww, Wwf, Ds, Ds, Ds, Re, Re, Re, Re, Re, Hh^Fdf, Re, Re, Gs^Fdf, Hh, Hh, Re, Gs^Fdf, Re, Re, Hh, Re, Re, Re, Hh
Re, Re, Re, Re, Re, Re, Hh, Rd, Rd, Re, Re, Re, Hh, Hh, Re, Re, Re, Re, Ds, Ds, Wo, Wo, Mm, Ww, Wwr, Wwr, Ss, Wwr, Wwr, Ww, Mm, Wo, Wo, Ds, Ds, Re, Re, Gs^Fdf, Gs^Fdf, Re, Re, Gg^Ve, Re, Re, Re, Re, Re, Hh^Fdf, Md^Xm, Hh^Fdf, Hh, Hh, Hh
Gs^Fdf, Gs^Fdf, Gs^Fdf, Re, Gs^Fdf, Hh, Md^Xm, Hh, Hh, Rd, Hh^Fdf, Re, Gg^Vc, Gg, Gg, Re, Ds, Ds, Wo, Wo, Wo, Wo, Mm, Wwr, Wo, Wwf, Ss, Wwf, Wo, Wwr, Mm, Wo, Wo, Wo, Wo, Ds, Ds, Re, Wwf, Wwr, Re, Re, Re, Re, Re, Re, Re, Hh^Fdf, Md^Xm, Md^Xm, Hh, Hh, Hh
Gs^Fdf, Gs^Fdf, Gs^Fdf, Re, Re, Md^Xm, Md^Xm, Md^Xm, Md^Xm, Md^Xm, Gs^Fdf, Re, Rd, Gg, Hh^Fdf, Wwf, Wo, Wo, Wo, Wo, Wo, Wo, Mm, Wo, Wwr, Wwr, Ss, Wwr, Wwr, Wo, Mm, Wo, Wo, Wo, Wo, Wo, Wo, Ww, Hh, Hh^Fdf, Gg, Re, Hh, Re, Gs^Fdf, Re, Re, Hh, Hh, Hh, Re, Re, Re
Gs^Fdf, Gs^Fdf, Rd, Re, Re, Gs^Fdf, Hh^Fdf, Hh^Fdf, Gs^Fdf, Gs^Fdf, Re, Re, Re, Gg, Ds, Dd^Do, Wo, Wo, Wo, Wo, Wo, Wo, Mm, Wwr, Wo, Wwf, Ss, Wwf, Wo, Wwr, Mm, Wo, Wo, Wo, Wo, Wo, Wo, Dd^Do, Ds, Gg, Re, Re, Hh, Md^Xm, Md^Xm, Gs^Fdf, Re, Re, Re, Re, Re, Re, Re
Re, Rd, Gg^Vh, Re, Re, Gs^Fdf, Gs^Fdf, Gs^Fdf, Re, Re, Re, Re, Re, Re, Ds, Wwf, Wo, Wo, Wo, Wo, Wo, Wo, Mm, Wo, Wwr, Wwr, Ss, Wwr, Wwr, Wo, Mm, Wo, Wo, Wo, Wo, Wo, Wo, Wwr, Ds, Ds, Re, Hh, Md^Xm, Md^Xm, Hh, Gs^Fdf, Re, Re, Gg^Vh, Re, Re, Re, Gs^Fdf
Re, Re, Re, Re, Re, Re, Re, Re, Re, Re, Re, Hh^Fdf, Hh^Fdf, Ds, Wo, Wo, Wo, Wo, Wo, Wo, Wo, Wo, Mm, Wwr, Wo, Wwf, Hh, Wwf, Wo, Wwr, Mm, Wo, Wo, Wo, Wo, Wo, Wo, Wo, Wo, Ds, Md^Xm, Md^Xm, Hh^Fdf, Hh^Fdf, Re, Re, Re, Re, Re, Rd, Gs^Fdf, Gs^Fdf, Gs^Fdf
Re, Re, Re, Re, Re, Re, Re, Re, Re, Re, Re, Re, Ds, Ds, Mm, Wo, Wo, Wo, Wo, Wo, Wo, Wo, Mm, Wo, Wwr, Wwr, Ww, Wwr, Wwr, Wo, Mm, Wo, Wo, Wo, Wo, Wo, Wo, Wo, Mm, Ds, Ds, Hh, Re, Re, Re, Re, Re, Re, Re, Hh, Gs^Fdf, Gs^Fdf, Gs^Fdf
Gs^Fdf, Re, Re, Hh, Re, Gg^Vh, Re, Re, Re, Gg^Vh, Rd, Re, Ds, Wwf, Ww, Mm, Mm, Wo, Wo, Wo, Mm, Mm, Wwr, Wwr, Wo, Ww, Ss^Vhs, Ww, Wo, Wwr, Wwr, Mm, Mm, Wo, Wo, Wo, Mm, Mm, Ww, Wwf, Ds, Re, Re, Re, Re, Gg^Vh, Re, Re, Re, Hh, Hh, Gs^Fdf, Rd
Gs^Fdf, Gs^Fdf, Re, Re, Re, Re, Gs^Fdf, Hh^Fdf, Re, Rd, Hh, Hh^Fdf, Ds, Wwf, Ww, Wo, Wwr, Mm, Mm, Mm, Wwr, Wwr, Wo, Wo, Ss, Wwf, Wo, Wwf, Ss, Wo, Wo, Wwr, Wwr, Mm, Mm, Mm, Wwr, Wo, Ww, Wwf, Ds, Re, Gs^Fdf, Gs^Fdf, Re, Re, Re, Re, Re, Re, Gg^Vh, Rd, Rd
Gs^Fdf, Gs^Fdf, Re, Re, Re, Re, Re, Re, Re, Re, Hh, Hh, Ds, Wwf, Wwr, Wo, Wwr, Wo, Wwr, Wo, Wwr, Wo, Ss, Ss, Wo, Wo, Hh, Wo, Wo, Ss, Ss, Wo, Wwr, Wo, Wwr, Wo, Wwr, Wo, Wwr, Wwf, Ds, Re, Re, Re, Re, Re, Re, Re, Hh^Fdf, Re, Re, Rd, Re
Re, Re, Rd, Gg^Vh, Hh, Re, Re, Re, Gs^Fdf, Re, Re, Re, Wwr, Wwf, Wwr, Wwf, Wwr, Wo, Wwr, Wwf, Wwr, Wo, Wwf, Wo, Wo, Wo, Hh, Wo, Wo, Wo, Wwf, Wo, Wwr, Wo, Wwr, Wwf, Wwr, Wo, Wwr, Wwf, Wwr, Re, Re, Gg^Vh, Ww, Re, Re, Hh, Hh, Hh, Hh^Fdf, Re, Re
Ww, Ww, Ww, Ww, Ww, Ww, Ww^Bw|, Re, Ww, Re, Ww, Ww, Wwf, Wwr, Ss, Ss, Ss, Wwf, Ss, Ss, Hh, Ww, Ss^Vhs, Wo, Hh, Hh, Chs, Hh, Hh, Wo, Ss^Vhs, Ww, Hh, Wwf, Ss, Ss, Ss, Wwf, Ss, Wwr, Wwf, Ww, Ww, Ww, Ww, Ww, Ww^Bw|, Ww, Ww, Ww, Ww, Ww, Ww
Re, Re, Re, Gs^Fdf, Gs^Fdf, Re, Re, Ww, Ww, Ww, Gg, Re, Wwr, Wwr, Wwr, Wwf, Wwr, Ss, Wwr, Wwf, Wwr, Ww, Wwf, Wo, Wo, Hh, Hh, Hh, Wo, Wo, Wwf, Ww, Wwr, Ss, Wwr, Wwf, Wwr, Ss, Wwr, Wwr, Wwr, Re, Gs^Fdf, Gs^Fdf, Re, Re, Re, Re, Re, Re, Gg^Vh, Re, Hh
Gs^Fdf, Re, Re, Gs^Fdf, Re, Re, Re, Re, Re, Gg^Vh, Rd, Re, Ds, Wwf, Wwr, Wo, Wwr, Wwf, Wwr, Wo, Wwr, Wo, Ss, Wo, Wo, Wo, Hh, Wo, Wo, Wo, Ss, Wo, Wwr, Wwf, Wwr, Wo, Wwr, Wwf, Wwr, Wwf, Ds, Re, Re, Gs^Fdf, Re, Re, Re, Re, Re, Re, Re, Rd, Hh
Gs^Fdf, Gs^Fdf, Gg^Vh, Re, Re, Re, Re, Hh^Fdf, Re, Re, Hh^Fdf, Hh^Fdf, Ds, Wwf, Ww, Wo, Wwr, Wo, Mm, Wo, Wwr, Wo, Wo, Ss, Ss, Wo, Wo, Wo, Ss, Ss, Wo, Wo, Wwr, Wo, Mm, Wo, Wwr, Wo, Ww, Wwf, Ds, Re, Re, Re, Re, Re, Gg^Vh, Rd, Re, Re, Re, Hh, Hh
Gs^Fdf, Rd, Rd, Re, Hh, Gg^Vh, Rd, Rd, Re, Re, Re, Re, Ds, Wwf, Ww, Wo, Mm, Mm, Wo, Mm, Mm, Wwr, Wwr, Wo, Wo, Wwf, Ss^Vhs, Wwf, Wo, Wo, Wwr, Wwr, Mm, Mm, Wo, Mm, Mm, Wo, Ww, Wwf, Ds, Re, Rd, Re, Re, Re, Hh, Hh, Re, Re, Re, Gs^Fdf, Re
Gs^Fdf, Gs^Fdf, Re, Re, Re, Re, Hh, Hh, Rd, Re, Re, Re, Ds, Wwf, Mm, Mm, Wo, Wo, Wo, Wo, Wo, Mm, Mm, Wwr, Wwr, Ww, Ww, Ww, Wwr, Wwr, Mm, Mm, Wo, Wo, Wo, Wo, Wo, Mm, Mm, Wwf, Ds, Hh, Gs^Fdf, Gg^Vh, Re, Re, Re, Hh, Re, Re, Re, Re, Re
Gs^Fdf, Gs^Fdf, Re, Re, Md^Xm, Re, Re, Re, Re, Gg^Vh, Re, Hh^Fdf, Hh^Fdf, Ds, Wo, Wo, Wo, Wo, Wo, Wo, Wo, Wo, Mm, Wo, Wo, Wwr, Hh, Wwr, Wo, Wo, Mm, Wo, Wo, Wo, Wo, Wo, Wo, Wo, Wo, Ds, Re, Hh, Gs^Fdf, Re, Re, Re, Re, Re, Re, Gg^Vh, Re, Re, Re
Re, Re, Re, Md^Xm, Re, Re, Re, Re, Re, Re, Re, Re, Re, Ds, Ds, Wo, Wo, Wo, Wo, Wo, Wo, Wo, Mm, Wwr, Wwr, Wwf, Ss, Wwf, Wwr, Wwr, Mm, Wo, Wo, Wo, Wo, Wo, Wo, Wo, Ds, Ds, Re, Re, Re, Re, Hh, Re, Re, Re, Re, Re, Re, Re, Re
Re, Re, Re, Re, Re, Re, Md^Xm, Re, Md^Xm, Hh, Md^Xm, Re, Re, Ds, Ds, Wwr, Wo, Wo, Wo, Wo, Wo, Wo, Mm, Wo, Wo, Wwr, Ss, Wwr, Wo, Wo, Mm, Wo, Wo, Wo, Wo, Wo, Wo, Wwr, Ds, Re, Re, Re, Hh, Hh, Md^Xm, Hh, Md^Xm, Hh, Hh, Hh, Hh^Fdf, Rd, Gs^Fdf
Re, Re, Hh, Hh, Md^Xm, Md^Xm, Md^Xm, Md^Xm, Md^Xm, Md^Xm, Hh, Re, Re, Gg, Hh, Dd^Do, Wo, Wo, Wo, Wo, Wo, Wo, Mm, Wwr, Wwr, Wwf, Ss, Wwf, Wwr, Wwr, Mm, Wo, Wo, Wo, Wo, Wo, Wo, Dd^Do, Hh^Fdf, Gg, Rd, Gs^Fdf, Gs^Fdf, Md^Xm, Md^Xm, Md^Xm, Md^Xm, Md^Xm, Md^Xm, Md^Xm, Hh, Hh^Fdf, Gs^Fdf
Re, Re, Hh^Fdf, Md^Xm, Md^Xm, Md^Xm, Hh, Hh, Gs^Fdf, Md^Xm, Re, Re, Re, Gg, Hh^Fdf, Wwf, Ds, Wo, Wo, Wo, Wo, Wo, Mm, Wo, Wo, Wwr, Ss, Wwr, Wo, Wo, Mm, Wo, Wo, Wo, Wo, Wo, Ds, Wwf, Gg, Gg, Gg^Vc, Hh, Hh, Md^Xm, Md^Xm, Md^Xm, Md^Xm, Md^Xm, Hh, Hh, Rd, Gs^Fdf, Gs^Fdf
Hh^Fdf, Re, Re, Md^Xm, Md^Xm, Md^Xm, Re, Gs^Fdf, Re, Re, Re, Gs^Fdf, Re, Rd, Re, Re, Re, Ds, Ds, Wo, Wo, Wo, Mm, Wwr, Wwr, Wwf, Ss, Wwf, Wwr, Wwr, Mm, Wo, Wo, Wo, Ds, Ds, Gs^Fdf, Re, Re, Re, Re, Rd, Re, Hh, Re, Hh, Re, Hh, Re, Gg^Vc, Re, Re, Gs^Fdf
Hh^Fdf, Re, Re, Re, Re, Re, Re, Re, Gg^Ve, Re, Re, Hh^Fdf, Hh, Gg^Ve, Re, Re, Re, Re, Re, Ds, Ds, Wo, Ds, Ww, Ww, Wwr, Ss, Wwr, Ww, Ww, Ds, Wo, Ds, Ds, Hh^Fdf, Hh, Gs^Fdf, Re, Re, Re, Re, Re, Gs^Fdf, Re, Re, Gg^Vc, Rd, Re, Re, Re, Re, Re, Re
Re, Re, Re, Re, Hh, Re, Re, Rd, Re, Re, Gs^Fdf, Re, Re, Re, Re, Re, Re, Re, Re, Re, Re, Ds, Ds, Wwf, Wwf, Wwf, Wwr, Wwf, Wwf, Wwf, Ds, Ds, Re, Re, Re, Gs^Fdf, Re, Re, Hh, Re, Hh, Re, Re, Re, Re, Re, Hh, Re, Re, Re, Re, Re, Re
Gs^Fdf, Re, Rd, Gg^Ve, Re, Re, Re, Gs^Fdf, Gs^Fdf, Hh^Fdf, Hh^Fdf, Gs^Fdf, Hh, Re, Re, Re, Hh^Fdf, Re, Re, Re, Re, Re, Re, Ds, Ds, Wwr, Ww, Wwr, Ds, Ds, Re, Re, Hh^Fdf, Re, Re, Rd, Re, Re, Hh, Hh, Hh^Fdf, Hh^Fdf, Re, Re, Hh, Hh, Md^Xm, Hh, Gs^Fdf, Gs^Fdf, Gs^Fdf, Re, Re
Gs^Fdf, Gs^Fdf, Gs^Fdf, Re, Re, Re, Hh, Hh^Fdf, Md^Xm, Md^Xm, Md^Xm, Hh, Re, Re, Re, Hh^Fdf, Md^Xm, Hh, Gs^Fdf, Re, Re, Re, Re, Hh^Fdf, Re, Re, Ww, Re, Re, Re, Re, Re, Re, Re, Re, Re, Hh^Fdf, Re, Re, Hh^Fdf, Re, Re, Re, Gs^Fdf, Hh, Md^Xm, Md^Xm, Md^Xm, Md^Xm, Gs^Fdf, Gs^Fdf, Re, Re
Hd, Gs^Fdf, Re, Gs^Fdf, Re, Gs^Fdf, Hh, Hh, Md^Xm, Md^Xm, Hh, Hh, Re, Re, Re, Hh^Fdf, Re, Re, Re, Re, Re, Re, Gg^Vh, Re, Re, Re, Ww, Gg^Vh, Rd, Re, Hh, Hh, Gg^Vh, Re, Re, Hh^Fdf, Hh, Re, Re, Re, Gs^Fdf, Re, Re, Gs^Fdf, Hh, Md^Xm, Hh, Md^Xm, Md^Xm, Md^Xm, Hd, Re, Re
Hd, Hd, Hd, Re, Re, Re, Re, Hh, Gs^Fdf, Hh, Re, Re, Re, Re, Re, Re, Re, Re, Re, Re, Re, Rd, Rd, Hh, Hh^Fdf, Re, Ww, Re, Re, Rd, Rd, Hh, Re, Re, Re, Hh, Md^Xm, Hh, Hh^Fdf, Re, Re, Gg^Ve, Re, Re, Re, Hh, Re, Rd, Gg^Ve, Hd, Hd, Hd, Hd
Md, Hd, Gs^Fdf, Re, Re, Re, Gs^Fdf, Re, Re, Re, Gg^Vc, Hh, Re, Re, Hh, Hh, Hh^Fdf, Re, Re, Re, Hh^Fdf, Hh^Fdf, Re, Hh, Re, Re, Ww^Bw/, Re, Re, Re, Re, Re, Hh^Fdf, Re, Re, Hh, Hh, Md^Xm, Md^Xm, Hh^Fdf, Gs^Fdf, Re, Re, Re, Gs^Fdf, Re, Gs^Fdf, Re, Re, Re, Md, Hd, Hd
Md, Md, Md, Hd, Re, Re, Re, Re, Re, Re, Re, Re, Re, Re, Hh, Md^Xm, Md^Xm, Re, Rd, Re, Re, Re, Re, Re, Re, Re, Ww, Gs^Fdf, Re, Re, Re, Re, Re, Hh^Fdf, Re, Re, Hh, Md^Xm, Md^Xm, Hh^Fdf, Gs^Fdf, Re, Re, Gs^Fdf, Re, Gs^Fdf, Re, Re, Re, Md, Md, Md, Md
Md, Md, Gs^Fdf, Re, Re, Re, Re, Re, Re, Hh, Hh, Rd, Re, Re, Re, Hh, Md^Xm, Md^Xm, Rd, Gg^Vh, Re, Re, Re, Gg^Vh, Re, Re, Ww, Re, Re, Re, Gg^Vh, Re, Re, Re, Gg^Vh, Rd, Hh, Hh, Md^Xm, Hh, Gs^Fdf, Gs^Fdf, Re, Re, Re, Re, Re, Re, Re, Re, Md, Md, Md
Md, Md, Hd, Re, Rd, Gg^Vc, Rd, Re, Re, Re, Re, Re, Re, Re, Rd, Gs^Fdf, Md^Xm, Md^Xm, Hh, Re, Re, Re, Gs^Fdf, Rd, Re, Rd, Ww, Hh, Hh, Re, Re, Re, Re, Re, Re, Re, Re, Hh, Md^Xm, Md^Xm, Re, Re, Re, Re, Re, Gg^Ve, Re, Re, Re, Re, Md, Md, Md
Md^Xm, Md, Md, Hd, Hd, Hd, Md, Hd, Hd, Re, Re, Re, Re, Gg^Vc, Re, Re, Hh, Md^Xm, Md^Xm, Re, Re, Re, Gs^Fdf, Re, Re, Gg^Vh, Ww, Hh, Hh^Fdf, Re, Re, Re, Re, Re, Re, Re, Re, Re, Hh, Hh, Re, Re, Re, Re, Hd, Re, Hd, Re, Md, Md, Md, Md, Md^Xm
Md^Xm, Md^Xm, Md^Xm, Md, Md, Md, Md, Md, Hd, Gs^Fdf, Gs^Fdf, Re, Re, Re, Re, Re, Md^Xm, Md^Xm, Md^Xm, Re, Gs^Fdf, Gs^Fdf, Gs^Fdf, Gs^Fdf, Re, Re, Ww, Hh^Fdf, Hh, Hh, Gs^Fdf, Rd, Gs^Fdf, Gs^Fdf, Hh^Fdf, Re, Re, Re, Re, Re, Re, Re, Gs^Fdf, Hd, Md, Hd, Md, Md, Md, Md, Md^Xm, Md^Xm, Md^Xm
Xv, Md^Xm, Xv, Md, Xv, Md, Xv, Md, Xv, Gs^Fdf, Xv, Re, Xv, Gs^Fdf, Xv, Re, Xv, Md^Xm, Xv, Hh, Xv, Gs^Fdf, Xv, Gs^Fdf, Xv, Re, Xv, Hh, Xv, Hh, Xv, Gs^Fdf, Xv, Hh^Fdf, Xv, Hh, Xv, Gs^Fdf, Xv, Re, Xv, Gs^Fdf, Xv, Hd, Xv, Md, Xv, Md, Xv, Md, Xv, Md^Xm, Xv
Xv, Xv, Xv, Xv, Xv, Xv, Xv, Xv, Xv, Xv, Xv, Xv, Xv, Xv, Xv, Xv, Xv, Xv, Xv, Xv, Xv, Xv, Xv, Xv, Xv, Xv, Xv, Xv, Xv, Xv, Xv, Xv, Xv, Xv, Xv, Xv, Xv, Xv, Xv, Xv, Xv, Xv, Xv, Xv, Xv, Xv, Xv, Xv, Xv, Xv, Xv, Xv, Xv
Xv, Xv, Xv, Xv, Xv, Xv, Xv, Xv, Xv, Xv, Xv, Xv, Xv, Xv, Xv, Xv, Xv, Xv, Xv, Xv, Xv, Xv, Xv, Xv, Xv, Xv, Xv, Xv, Xv, Xv, Xv, Xv, Xv, Xv, Xv, Xv, Xv, Xv, Xv, Xv, Xv, Xv, Xv, Xv, 1 Xv, Xv, 2 Xv, Xv, 3 Xv, Xv, Xv, Xv, Xv
Xv, Xv, Xv, Xv, Xv, Xv, Xv, Xv, Xv, Xv, Xv, Xv, Xv, Xv, Xv, Xv, Xv, Xv, Xv, Xv, Xv, Xv, Xv, Xv, Xv, Xv, Xv, Xv, Xv, Xv, Xv, Xv, Xv, Xv, Xv, Xv, Xv, Xv, Xv, Xv, Xv, Xv, Xv, Xv, Xv, Xv, Xv, Xv, Xv, Xv, Xv, Xv, Xv
Xv, Xv, Xv, Xv, Xv, Xv, Xv, Xv, Xv, Xv, Xv, Xv, Xv, Xv, Xv, Xv, Xv, Xv, Xv, Xv, Xv, Xv, Xv, Xv, Xv, Xv, Xv, Xv, Xv, Xv, Xv, Xv, Xv, Xv, Xv, Xv, Xv, Xv, Xv, Xv, Xv, Xv, Xv, Xv, 4 Xv, Xv, 5 Xv, Xv, 6 Xv, Xv, Xv, Xv, Xv
Xv, Xv, Xv, Xv, Xv, Xv, Xv, Xv, Xv, Xv, Xv, Xv, Xv, Xv, Xv, Xv, Xv, Xv, Xv, Xv, Xv, Xv, Xv, Xv, Xv, Xv, Xv, Xv, Xv, Xv, Xv, Xv, Xv, Xv, Xv, Xv, Xv, Xv, Xv, Xv, Xv, Xv, Xv, Xv, Xv, Xv, Xv, Xv, Xv, Xv, Xv, Xv, Xv
Xv, Xv, Xv, Xv, Xv, Xv, Xv, Xv, Xv, Xv, Xv, Xv, Xv, Xv, Xv, Xv, Xv, Xv, Xv, Xv, Xv, Xv, Xv, Xv, Xv, Xv, Xv, Xv, Xv, Xv, Xv, Xv, Xv, Xv, Xv, Xv, Xv, Xv, Xv, Xv, Xv, Xv, Xv, Xv, Xv, Xv, Xv, Xv, Xv, Xv, Xv, Xv, Xv
Xv, Xv, Xv, Xv, Xv, Xv, Xv, Xv, Xv, Xv, Xv, Xv, Xv, Xv, Xv, Xv, Xv, Xv, Xv, Xv, Xv, Xv, Xv, Xv, Xv, Xv, Xv, Xv, Xv, Xv, Xv, Xv, Xv, Xv, Xv, Xv, Xv, Xv, Xv, Xv, Xv, Xv, Xv, Xv, Xv, Xv, Xv, Xv, Xv, Xv, Xv, Xv, Xv
