Wo, Wo, Wo, Wo, Wo, Wo, Wo, Wo, Wo, Wo, Wo, Wo, Wo, Wo, Wo, Wo, Wo, Wo, Wo, Wwf, Gs^Fp, Aa, Ms, Ms, Gs^Fp, Aa^Fda, Gg, Gg, Gs^Fp, Gg, Gg, Gg, Gs^Fp, Wo, Wo, Wo, Wo, Wo, Wo, Wo, Gs^Fp, Wwf, Wwf, Wwf, Wwf, Gs^Fp, Wwf, Gs^Fp, Gs^Fp, Gs^Fp
Wo, Wo, Wo, Wo, Wo, Wo, Wo, Wo, Wo, Wo, Wo, Wo, Wo, Wo, Wo, Wo, Wo, Wo, Wo, Wwf, Gs^Fp, Ha^Fpa, Ha, Ha, Gs^Fp, Aa^Fda, Gs^Fp, Gg, Gg, Gg, Gg, Gs^Fp, Gg, Gg, Wo, Wo, Wo, Wo, Wo, Wo, Gs^Fp, Gs^Fp, Wwf, Gs^Fp, Wwf, Gs^Fp, Aa, Gs^Fp, Aa, Aa^Fpa
Wo, Wo, Wo, Wo, Wo, Wo, Wo, Wo, Wo, Wo, Wo, Wo, Wo, Wwf, Wo, Wo, Wo, Wo, Wo, Gg^Vh, Gg, Aa, Aa, Aa^Fda, Gs^Fp, Gs^Fp, Gg, Aa^Fpa, Gg, Gg, Gs^Fp, Gs^Fp, Gs^Fp, Gg, Gs^Fp, Wo, Wo, Wo, Wo, Gs^Fp, Gs^Fp, Wwf, Gs^Fp, Wwf, Wwf, Gs^Fp, Aa^Fpa, Aa, Ai, Aa
Wo, Wo, Wo, Wo, Wo, Wo, Wo, Wo, Wo, Wo, Wwr, Wo, Aa, Wo, Wo, Wo, Wo, Wo, Wo, Wwf, Wwf, Gs^Fp, Gg, Gg, Gg, Gg, Gg, Gg^Vh, Gg, Gg, Gg, Gs^Fp, Gg, Gg, Gg, Gg, Wo, Wo, Gs^Fp, Gs^Fp, Re^Gvs, Gs^Fp, Gg^Ve, Gs^Fp, Gs^Fp, Aa, Aa, Ai, Aa^Fpa, Aa
Wo, Wo, Wo, Wo, Wo, Wo, Wo, Wo, Wo, Wo, Gg, Aa, Wo, Wo, Wo, Wo, Wo, Wo, Wo, Wo, Wwf, Gg, Gs^Fp, Gs^Fp, Gg, Gg, Gg, Gg, Gg, Gs^Fp, Gs^Fp, Hh, Gs^Fp, Gg, Gg, Gs^Fp, Wo, Wo, Wo, Wo, Wo, Wo, Wo, Wo, Wo, Aa, Gg, Ai, Aa^Fpa, Aa^Fpa
Wo, Wo, Wo, Wo, Wo, Wo, Wo, Wo, Wwf, Wwf, Aa, Gg, Wo, Wo, Wo, Wo, Wo, Wo, Wo, Wo, Wo, Gg, Gs^Fp, Gg, Gg, Gs^Fp, Wo, Gs^Fp, Hh, Gg, Ww, Gs^Fp, Gs^Fp, Hh, Gg, Gg^Vh, Wo, Wo, Wo, Wo, Wo, Wo, Wo, Wo, Wo, Wo, Gg^Ve, Gg, Aa^Fpa, Aa
Wo, Wo, Wo, Wo, Wo, Wo, Wo, Wo, Wo, Wwf, Gg^Vh, Gg, Ha, Wo, Wo, Wo, Wo, Wo, Wo, Wo, Wo, Wo, Wo, Gg, Wo, Wo, Wo, Wo, Wo, Gg, Gg, Wwf, Gs^Fp, Gs^Fp, Wo, Wo, Wo, Wo, Wo, Wo, Gs^Fp, Gs^Fp, Gg^Vh, Gs^Fp, Gs^Fp, Gs^Fp, Gs^Fp, Gg, Gg, Aa^Fpa
Wo, Wo, Wo, Wo, Wo, Wo, Wo, Wo, Ww, Aa, Gs^Fp, Ha, Gg, Wo, Wo, Wo, Wo, Wo, Wo, Wo, Wo, Wo, Wo, Wo, Wo, Wo, Gg, Wo, Wo, Gg^Vh, Gg, Gs^Fp, Gg, Gs^Fp, Wo, Wo, Wo, Wo, Wo, Wo, Wo, Wo, Gg, Gg, Gg, Gg, Gg, Gs^Fp, Gs^Fp, Ai
Wo, Wo, Wo, Wo, Wo, Wo, Ha, Gg^Vh, Ww, Gg, Gg, Gg, Hh, Wo, Wo, Wo, Wo, Wo, Wo, Wo, Wo, Wo, Wo, Wo, Gg, Gg, Gg, Wo, Wo, Gs^Fp, Gs^Fp, Gs^Fp, Gs^Fp, Gs^Fp, Wo, Wo, Wo, Wo, Wo, Wo, Wo, Wo, Gg, Gs^Fp, Gg, Gs^Fp, Aa, Aa, Aa^Fpa, Ai
Wo, Wo, Wo, Wo, Wo, Wo, Gs^Fp, Gg, Wo, Wo, Gg, Gg, Gg, Wo, Wo, Wo, Wo, Wo, Wo, Wo, Wo, Wo, Wo, Wo, Gg, Gg, Gg^Vh, Wo, Wwf, Gg, Gs^Fp, Gs^Fp, Gs^Fp, Gs^Fp, Wo, Wo, Wo, Wo, Wo, Gg, Gg, Gg^Vh, Gg, Gg, Gs^Fp, Gs^Fp, Gg, Aa^Fpa, Gg, Gg
Wo, Wo, Wo, Wo, Gg, Gs^Fp, Gg, Gg, Wo, Wo, Gg^Vh, Gs^Fp, Gg, Gg, Wo, Wo, Wo, Wo, Wo, Wo, Wo, Wo, Wo, Wo, Gg, Gg, Wwf, Wwf, Gg, Gg, Wo, Gg, Wo, Gg, Wo, Wo, Wo, Wo, Gg, Gg, Gs^Fp, Gg, Aa, Gs^Fp, Gg, Gg, Aa^Fpa, Gg, Gg, Aa
Wo, Wo, Wo, Wo, Gg^Vh, Gg, Gs^Fp, Gg^Vh, Wo, Wo, Gg, Gg, Gg, Gg, Gg, Wo, Wo, Wo, Wo, Wo, Wo, Wo, Wo, Wo, Gg^Efm, Gs^Fp, Gg, Wwf, Gg, Gg^Vh, Wo, Wo, Wo, Wo, Wo, Wo, Wo, Wo, Gs^Fp, Gg, Gs^Fp, Gs^Fp, Aa^Fpa, Gg, Gg, Aa, Gg, Aa, Gg^Ve, Aa^Fpa
Wo, Wo, Wo, Wo, Wo, Hh, Wo, Gg, Wo, Gg, Gg, Gg, Gg, Gg, Gg, Wo, Wo, Wo, Wo, Wo, Wo, Wo, Wo, Wo, Gg^Vh, Gg^Efm, Wwf, Wwf, Wo, Wo, Wo, Wo, Wo, Wo, Wo, Wo, Wo, Wo, Gg, Gg, Gg, Gg, Gg, Gg, Gg, Gg, Aa^Fpa, Gg, Aa, Gg
Wo, Wo, Wo, Wo, Wo, Wo, Wo, Wo, Gg, Gs^Fp, Gg, Gg^Vh, Gg, Gg, Gg, Wo, Wo, Wo, Wo, Wo, Gg^Vh, Gg, Gg, Gg, Gg, Gs^Fp, Wwf, Wo, Gg, Wo, Wo, Wo, Wo, Wo, Wo, Wo, Gg, Gg, Gg, Gg^Vh, Gg, Aa^Fpa, Gg, Aa^Fpa, Re, Gg, Gg, Aa, Gg, Aa^Fpa
Wo, Wo, Wo, Wo, Wo, Wo, Wo, Gg, Wo, Gg, Gg, Gg, Gg, Gg, Gg^Vh, Gg, Ww, Wo, Wo, Wo, Gg, Gg, Gg, Gg, Gg, Gg, Gs^Fp, Gg, Gs^Fp, Wo, Gg, Wo, Gg, Gg, Wo, Wo, Gg, Gg, Gg, Gg, Gs^Fp, Gg, Gg^Vh, Gg, Gg, Gg, Gg^Vh, Gg, Gg, Gg
Wo, Wo, Wo, Wo, Wo, Wo, Wo, Wo, Gg, Gg, Gg, Gg, Wo, Gg, Gg, Gg, Ww, Ww, Gg, Gg, Gg, Gg, Hh, Gg, Gg, Hh, Gg, Gg, Gg, Gg, Gs^Fp, Gg, Gg, Gg, Gg, Gg, Gg, Gs^Fp, Gg, Gg, Gg, Gg, Gg, Aa^Fpa, Gg, Gg, Hh, Gg, Aa, Aa
Wo, Wo, Wo, Wo, Wo, Wo, Wo, Gg, Ww, Wo, Wo, Wo, Wo, Wo, Wo, Ww, Ww, Gg, Gg, Gg, Gg, Gg, Gg, Gs^Fp, Gg, Gg, Hh, Gg^Vh, Re, Hh, Gg, Gg, Gg, Gg, Gg^Vh, Gg, Gg, Gg, Gs^Fp, Gg, Gg, Gs^Fp, Gg, Gg, Gg, Gg, Gg, Gg, Gs^Fp, Aa
Wo, Wo, Wo, Wo, Wo, Wo, Wo, Wo, Ww, Ww, Wo, Wo, Gg, Wo, Wo, Wo, Gg, Gg, Hh, Gg^Vh, Gg, Gg, Gs^Fp, Gg, Gg, Gs^Fp, Gg, Re, Gs^Fp, Re, Re, Gg, Re, Re, Gg, Gg, Gg, Gg, Gg, Gg, Gg, Hh, Gg, Gg, Gg, Gg, Gs^Fp, Gg, Gg, Gg
Wo, Wo, Wo, Wo, Wo, Wo, Wo, Wo, Wo, Re, Re, Re, Gg, Gs^Fp, Gg, Gg, Gg, Gg, Gg, Gg, Gg, Gg, Gg^Vh, Hh, Gg, Gg, Gg, Hh, Gg, Gg, Gs^Fp, Re, Hh, Gs^Fp, Hh, Re, Re, Hh, Gs^Fp, Gs^Fp, Gg, Gg, Gg, Gg, Gg^Vh, Gg, Gg, Gg, Gs^Fp, Gg
Wo, Wo, Wo, Wo, Wo, Wo, Wo, Wo, Wo, Wo, Wo, Gg, Gg, Gg, Gg, Gg, Gg^Vh, Gg, Gg, Gg, Gg, Gg, Gs^Fp, Hh^Fmw, Hh^Fmw, Gg, Gg, Gg, Gg, Gg, Gg, Gg^Vh, Gg, Gg, Gg^Vh, Gg, Gs^Fp, Re, Gg, Gg, Gg, Gs^Fp, Gg, Gg, Gg, Gg, Gg, Gg, Gg^Vh, Gg
Wo, Wo, Wo, Wo, Wo, Wo, Wo, Wo, Wo, Wo, Wo, Gg^Vh, Gg, Gg, Gg, Gg, Gg, Gg, Gg, Gs^Fp, Gs^Fp, Hh^Fmw, Hh, Hh^Fmw, Gg, Gg, Gg, Gg^Vh, Gg, Gg, Gg, Gg, Gg, Gg, Gs^Fp, Hh, Gg, Hh, Hh, Gg, Gg, Gg, Gg, Gg, Gg, Gs^Fp, Gg, Gg, Gg, Gg
Wo, Wo, Wo, Wo, Wo, Wo, Wo, Wo, Wo, Wo, Wo, Wo, Gg, Gg, Gg, Gs^Fp, Gs^Fp, Gg, Hh, Gg, Gg, Gg, Gg, Gg, Gg^Ve, Gg, Mm, Gg, Hh, Gg, Hh, Gg, Gg, Gg, Gg, Gg, Gg, Gg, Gg, Gs^Fp, Gg, Hh^Fmw, Gg, Gg, Gg, Gg, Gg, Gg, Gg, Gg
Wo, Wo, Wo, Wo, Wo, Wo, Wo, Wo, Wo, Wo, Wo, Wo, Gg^Vh, Gg, Hh, Gg, Gg, Gg, Gg^Vh, Gg, Hh, Gg^Vh, Mm^Xm, Mm^Xm, Mm^Xm, Mm^Xm, Hh, Mm, Re, Hh, Re, Hh^Fmw, Hh^Fmw, Hh, Gg, Gg^Vh, Gg, Gg, Gg, Gg, Gg, Hh, Hh^Fmw, Gg, Gg, Gg, Gg^Vh, Gg, Gg, Gs^Fp
Wo, Wo, Wo, Wo, Wo, Wo, Wo, Wo, Wo, Wo, Wo, Wo, Gs^Fp, Gs^Fp, Gg, Gs^Fp, Gg, Gg, Gg, Gg, Hh, Mm, Gg, Gg, Gg^Vh, Hh, Gg, Re, Wo, Re, Gg, Re, Re, Gg, Hh, Gg, Gs^Fp, Gs^Fp, Gs^Fp, Gg, Gg, Hh, Hh, Gs^Fp, Gg, Gg, Wo, Gg, Gg, Gg
Wo, Wo, Wo, Wo, Hh, Wo, Hh, Wo, Hh, Wo, Wo, Wo, Gg, Gg, Gg, Gg, Gs^Fp, Gg, Gg, Gg, Gg, Hh, Gg, Gg, Gg, Re, Gg, Gg, Wo, Wo, Wo, Hh, Gg, Gg, Gg, Gg, Gg, Hh^Fmw, Gg, Gg, Gg^Vh, Gg, Gg, Gg, Gg, Wo, Wo, Wo, Gg, Gg
Wo, Wo, Wo, Hh, Hh, Hh, Gg, Hh, Gg, Hh, Gg, Hh, Mm, Gg, Hh, Gg, Gg, Gg, Gg^Vh, Gg, Wo, Rp^Vhc, Gg, Gg, Gg, Re, Re, Gs^Fp, Wo, Wo, Wo, Gs^Fp, Gg, Gg, Gg, Gg, Gg, Hh, Hh^Fmw, Gg, Gg, Hh, Gg, Gg^Vh, Wo, Wo, Wo, Wo, Wo, Wo
Wo, Wo, Wo, Wo, Hh, Gg, Gg, Gg, Gg, Gg, Gg, Gg, Gs^Fp, Hh, Gg^Vh, Gg, Wo, Gg, Wo, Wo, Wo, Wo, Wo, Wo, Wo, Gg, Re, Hh^Fp, Mm, Wo, Wo, Hh^Fmf, Hh^Fmf, Gg, Gs^Fp, Hh^Fp, Gg^Vh, Gg, Gg, Gg, Hh, Hh^Fmw, Gg, Gg, Wo, Wo, Wo, Wo, Wo, Wo
Wo, Wo, Wo, Wo, Gg^Vh, Gg, Gg, Hh^Fp, Gg^Vh, Gg, Gg, Gg, Hh, Gg, Wo, Wo, Wo, Wo, Wo, Wo, Wo, Wo, Wo, Wo, Wo, Gg, Gg^Vh, Re, Re, Wo, Wo, Wo, Wo, Mm, Gg, Gg, Gg, Gg, Gg, Gg, Gg, Gg, Gg, Gg, Ww, Wo, Wo, Wo, Wo, Wo
Wo, Wo, Wo, Wo, Gg, Gs^Fp, Ds, Gg, Gg, Hh, Gs^Fp, Gg, Gg, Gg, Wo, Wo, Wo, Wo, Wo, Wo, Wo, Wo, Wo, Hh^Fms, Wo, Wo, Wo, Gg, Hh^Fp, Re, Gg^Vh, Wo, Wo, Wo, Hh, Gg, Gg, Hh^Fp, Gg^Vh, Gg, Gg, Gg, Ww, Gg^Vh, Gg, Ww, Gg, Wo, Hh, Wo
Wo, Wo, Wo, Wo, Gg, Gg, Gg, Gg, Gs^Fp, Gg, Gg, Gg, Gg, Gg^Vh, Wo, Wo, Wo, Wo, Wo, Wo, Wo, Wo, Wo, Wo, Wo, Wo, Wo, Wo, Hh^Fp, Gg, Wo, Gg, Wo, Wo, Wo, Hh^Fms, Hh, Gg, Wo, Wo, Wo, Wo, Wo, Ww, Hh, Gg, Gs, Gg, Gg^Vh, Gg
Wo, Wo, Wo, Gg^Vh, Gg, Gg, Gg, Gg, Gg, Gg, Gg, Gg, Hh, Gg, Wo, Wo, Wo, Wo, Wo, Wo, Wo, Wo, Wo, Hh, Wo, Wo, Wo, Wo, Hh^Fp, Gg, Wo, Wo, Wo, Wo, Wo, Wo, Hh^Fms, Gg, Wo, Wo, Wo, Wwr, Wo, Wo, Gg^Vh, Gg, Hh, Gg, Gs, Gg
Wo, Wo, Wo, Wo, Gg, Gg, Gs^Fp, Gg^Vh, Gg, Hh, Hh, Hh, Wo, Wo, Wo, Wo, Wo, Wo, Wo, Wo, Wo, Wo, Wo, Wo, Wo, Wo, Hh, Ww, Wo, Wo, Wo, Wo, Wo, Wo, Wo, Wo, Mm, Gg^Vh, Wo, Wo, Wwr, Wwr, Wo, Wo, Wo, Gg, Gs, Gs, Gg, Gg
Wo, Wo, Wo, Wo, Wo, Wo, Wo, Gg, Wo, Wo, Wo, Wo, Wo, Wo, Wo, Wo, Rd, Gg, Rd, Gg, Gg, Gg, Wo, Wo, Wo, Gg^Vh, Wo, Wo, Wo, Wo, Wo, Wo, Wo, Wo, Wo, Wo, Wo, Wwr, Hh^Fds, Wo, Wo, Wo, Wo, Wo, Wwf, Gg, Hh, Gg, Mm, Gs
Wo, Wo, Wo, Wo, Wo, Wo, Wo, Wo, Wo, Wo, Wo, Wo, Gg, Gg, Rd, Rd, Dd, 5 Rd, Gg, 6 Gg, Gg, Gg, Wo, Wo, Wo, Wo, Wo, Wo, Wo, Wo, Wo, Wo, Wo, Wo, Wo, Wo, Wo, Wo, Wo, Hh^Fds, Wwr, Wwr, Wwf, Wwr, Wwf, Wo, Wo, Hh, Wo, Gg
Wo, Wo, Wo, Wo, Wo, Wo, Gg, Gg, Gg, Gg, Rd, Gg, 1 Dd, 8 Dd, 2 Dd, 9 Dd, 3 Dd^Do, Gs, 4 Gs, Gs, Gs, Wo, Wo, Wo, Wo, Wo, Wo, Wo, Wo, Wo, Wo, Wo, Wo, Wo, Wo, Wo, Wo, Wo, Wo, Wo, Wo, Wo, Wo, Wo, Wo, Wo, Wo, Wo, Wo, Wo
Wo, Wo, Wo, Wo, Wo, Gg, Gg, Gg, Rd, Rd, Dd, Dd, Dd, Dd, Dd, Dd, Dd, Dd, Rd, Gg, Gg, Wo, Wo, Wo, Wo, Wo, Wo, Wo, Wo, Wo, Wo, Wo, Wo, Wo, Wo, Wo, Wo, Wo, Wo, Wo, Wo, Wo, Wo, Wo, Wo, Wo, Wo, Wo, Wo, Wo
