Wo, Wo, Wo, Wo, Wo, Wo, Wo, Wo, Wo, Wo, Wo, Wo, Wo, Wo, Wo, Wo, Wo, Wo, Wo, Wo, Ww, Wo, Ai, Ai, Aa, Aa, Aa, Aa, Aa, Aa, Aa, Aa, Aa, Aa, Aa, Aa, Aa, Aa, Aa, Aa, Aa, Aa, Aa, Aa, Aa, Aa, Aa, Aa, Aa, Aa, Aa
Wo, Wo, Wo, Wo, Ai, Wo, Wo, Wo, Wo, Ai, Wo, Ww, Wo, Wo, Wo, Ai, Wo, Wo, Wo, Wo, Ww, Wwf, Rr^Vd, Re, Aa, Aa, Aa, Aa, Aa, Aa, Aa, Aa, Aa, Aa, Aa, Aa, Re, Aa, Aa, Aa, Aa, Aa, Re, Aa, Ms, Ms, Xol, Ms, Ms, Aa, Aa
Wo, Wo, Wo, Ai, Wo, Wo, Wo, Ww, Wo, Wo, Wwf, Ww, Hh, Wo, Wo, Wo, Wo, Wo, Ww, Wo, Wwf, Wwf, Re, Re, Re, Aa, Re, Aa, Aa, Aa, Aa, Aa, Aa, Aa, Aa, Re, Uu^Vu, Hh, Re, Aa, Re, Re, Hh, Uu^Vu, Re, Xol, Re, Xol, Aa, Aa, Aa
Wo, Wo, Wo, Wo, Wo, Wo, Wo, Wo, Ww, Wwf, Hh, Mm^Vhh, Hh, Ai, Wo, Wo, Ww, Ai, Ai, Ww, Ms, Ms, Ms, Aa, Ms, Re, Re, Aa, Re, Re, Hh, Aa, Re, Ch, Re, Re, Hh, Re, Aa, Re, Ms, Re, Re, Ms, Xol, Re, Re, Aa, Gg, Aa, Gg
Wo, Wo, Wo, Wo, Ai, Wo, Wo, Wo, Xol, Ms, Re, Mm, Re, Wo, Wwf, Wwf, Ww, Wo, Ai, Ai, Aa, Gg, Ha, Ms, Ms, Ha, Aa, Re, Re, Uu^Vu, Re, Re, Hh, Re, Hh, Re, Xol, Xol, Mm, Xol, Mm, Xol, Xol, Xol, Xol, Hh, Xol, Gg, Gg, Gg, Gg
Wo, Wo, Wo, Wo, Wo, Wo, Xol, Xol, Ai, Ai, Re, Ch, Hh, Re, Re, Uu^Vu, Wwf, Ai, Aa, Aa, Gg, Gg, Gg, Aa, Ms, Ha, Re, Re, Aa, Re, Xol, Xol, Xol, Xol, Xol, Xol, Gg, Xol, Gg, Mm, Gg, Gg, Gg, Gg, Gg, Gg, Gg, Xol, Mm, Gg, Gg
Wo, Wo, Wo, Wo, Wo, Wo, Gg, Gg, Re, Re, Hh, Hh, Ms, Ha, Aa, Re, Wwf, Aa, Gg, Gg, Aa, Gg, Ch, Gg, Gg, Hh, Mm, Mm, Mm, Gg, Gg, Xol, Gg, Mm, Gg, Gg, Gs^Fds, Gg, Gg, Wo, Wo, Wo, Wo, Gs^Fds, Gs^Fds, Gg, Gg, Gg, Gg, Gg, Gg
Wo, Wo, Wo, Wo, Wo, Wo, Gg, Ch, Xol, Mm, Xol, Mm, Xol, Xol, Gg, Aa, Chw, Gg, Gg, Gg, Gg, Gg, Wo, Wo, Gg, Hh, Xol, Mm, Xol, Gg, Gg, Gg, Gg, Hh^Fms, Gg, Gg, Gg, Gg, Gg, Gs^Fds, Gs^Fds, Gs^Fds, Ww, Gs^Fds, Gg, Gg, Gg, Hh^Vhh, Gg, Gg, Gg
Wo, Wo, Wwf, Wwf, Gg, Gg, Gs^Fds, Gg, Gg, Xol, Gg, Xol, Hh, Hh, Gg, Gg, Wwf, Gg, Gg, Gg, Gg, Wo, Wo, Wo, Gg, Xol, Gg, Mm, Xol, Hh, Wwf, Wo, Wo, Gg, Gg, Ch, Gg, Gs^Fds, Gg, Gs^Fds, Gg, Hh^Fms, Gs^Fds, Wwf, Ww, Ww, Ww, Mm, Gs^Fds, Gg, Gg
Wo, Wo, Wwf, Wwf, Gg, Gg, Gg, Gg, Wo, Gs^Fds, Gg^Vh, Rd, Rd, Hh^Fms, Wwf, Wwf, Hh, Gg, Gg, Hh, Gg, Wo, Wo, Wo, Wwf, Gg, Gg, Gg, Mm, Xol, Xol, Hh, Gg, Wo, Wo, Gg, Gg, Gg, Gg, Gg, Gg^Ve, Gs^Fds, Gs^Fds, Gs^Fds, Wo, Wo, Gg^Vh, Wwf, Gs^Fds, Gg, Gg
Wo, Wo, Ww, Gg^Ve, Gg, Wo, Wo, Wo, Wo, Wwf, Ww, Wwf, Wwf, Wwf, Hh, Rd, Gg, Gg, Gg, Hh, Gg, Gg, Wo^Bw/, Gg, Gg, Gg^Vh, Gg, Gg, Ww, Ww, Xol, Mm, Gs, Gg, Gg, Wo, Ww, Mm, Hh^Fms, Xol, Mm, Mm, Gs^Fds, Gs^Fds, Gs^Fds, Wo, Wo, Wo, Wo, Gg, Gg
Wo, Wo, Wo, Wwf, Ww, Ww, Wo, Wo, Wo, Wo, Wo, Wo, Gg, Hh, Gg, Rd, Gg^Vh, Rd, Rd, Ch, Rd, Rd, Ww, Gg, Rd, Rd, Rd, Ww, Wwf, Gg^Ve, Rd, Xol, Mm, Mm, Rd, Rd, Wwf^Bw/, Rd, Rd, Rd, Rd, Rd, Rd, Rd, Rd, Rd, Rd, Rd, Ww, Ww, Rd
Wo, Wo, Wo, Wo, Wo, Ww, Wwf, Ww, Gs^Fds, Gg, Rd, Rd, Rd, Ch, Rd, Rd, Rd, Gg, Hh, Gg, Gg, Wo^Bw\, Rd, Rd, Gg, Gg, Gg, Wo^Bw\, Rd, Rd, Hh^Fdf, Rd, Rd, Mm, Xol, Gg, Gg, Ww, Wo, Gg, Gg, Cv, Gg, Gg, Gs^Fds, Gs^Fds, Gs^Fds, Gs^Fds, Gg, Wwf, Ww
Wo, Wo, Wo, Wo, Wo, Ww, Hh, Gs^Fds, Gg^Ve, Rd, Mm, Gg, Gg, Rd, Hh^Fms, Gg, Gg, Rd, Rd, Gg, Gg, Wo, Gs^Fds, Gg^Vh, Gg, Gg, Gg, Ww, Gg, Hh^Fdf, Gg, Gg, Mm, Xol, Xol, Mm, Hh, Gg, Wo, Gg, Gs^Fds, Gg, Hh^Fms, Hh^Fms, Gs^Fds, Gg, Gg, Gs^Fds, Gs^Fds, Gg, Gg
Wo, Wo, Wo, Wo, Wo, Gg, Gg, Gg, Mm, Gg, Mm, Mm, Xol, Gg, Gg, Gg, Hh^Fms, Hh^Fms, Rd, Gg, Gg, Wo, Rd, Gg, Gg, Hh^Fms, Gg, Wo, Ww, Gg, Gg, Gg, Gg, Mm, Mm, Xol, Hh, Gg, Ww, Gg^Ve, Gg, Gs^Fds, Gs^Fds, Gs^Fds, Gg, Gg^Ve, Gs^Fds, Gs^Fds, Gg, Gs^Fds, Gg
Wo, Wo, Wo, Gg, Gg, Gg, Ch, Hh^Fms, Mm, Mm, Xol, Xol, Hh, Gg, Gg, Gg, Hh^Fms, Gg, Rd, Gg, Rd, Chw, Gg, Rd, Ch, Gg, Hh^Fms, Gg, Gg, Ww, Gg, Gg^Vh, Hh, Gg, Hh, Xol, Xol, Hh, Gg, Ww, Wo, Gs^Fds, Gg, Gs^Fdw, Gs^Fds, Gg, Gs^Fds, Gg, Gg, Gg, Gg
Wo, Wo, Ww, Gg, Gs^Fds, Gg, Hh^Fms, Mm, Mm, Xol, Xol, Xol, Hh, Hh, Gg, Gg, Gg, Gg, Rd, Rd, Gg, Wo, Wo, Gg, Gg, Rd, Gg, Hh^Fms, Gg, Ww, Ww, Gg, Gg, Gg, Gg, Md^Xm, Xol, Mm, Mm, Gg, Gs^Fmw, Wo, Gs^Fdw, Gs^Fdw, Gs^Fdw, Gs^Fds, Gs^Fds, Gg^Ve, Gg, Gg, Gg
Wo, Wo, Ww, Gg^Ve, Gg, Gg, Mm, Mm, Xol, Xol, Mm, Mm, Mm, Hh, Hh^Fms, Gg, Gg, Hh, Gg^Vh, Wwf, Gg, Hh, Gg, Wo, Gg, Rd, Gg, Gg, Gg, Gg, Wo, Gg, Gg, Gg, Uu^Vu, Mm, Xos, Xos, Ur, Gg, Ww, Wo, Ur, Ur, Ur, Gs^Fmw, Hh^Fmw, Gg, Gs^Fds, Gg, Gg
Wo, Wo, Wo, Wwf, Hh^Fms, Hh, Hh^Fms, Mm, Xol, Xol, Mm, Mm, Hh, Gg, Gg, Gg, Rd, Rd, Gg, Wwf, Wwf, Gg, Gg, Wo, Gg, Gg^Vh, Rd, Gg, Gg, Gg, Ww, Gg, Gg, Hh, Gg, Xol, Hh, Ur, Ur, Gg, Wwf^Bw/, Gs^Fmw, Ur, Uu^Vu, Ur, Gs^Fmw, Hh^Fmw, Hh^Fmw, Gg, Gg, Gg
Wo, Wo, Wo, Wo, Gg, Hh^Fms, Gg, Xol, Gg^Vh, Hh, Mm, Mm, Gg^Vh, Ch, Rd, Rd, Hh^Fms, Gg, Gg, Gg, Wwf, Ww, Wo, Wo, Gg, Gs^Fms, Rd, Gg, Gg, Gg, Ww, Gg, Gs^Fms, Gg, Gg, Xos, Ur, Uu^Vu, Xos, Gg, Gg, Ww, Gg, Hh, Gg, Hh, Gs^Fds, Gs^Fds, Gg, Gg, Gg
Wo, Wo, Wo, Wo, Wo, Wo, Gg, Gg, Wwf, Mm, Mm, Chw, Mm, Rd, Gg, Gg, Gg, Gg, Gg, Gg, Wo, Wo, Gg, Gg, Gg^Ve, Gs^Fds, Gg, Rd, Ch, Gg, Ww, Gg, Gs^Fms, Gs^Fms, Ch, Gg, Ur, Ur, Xos, Gg, Gg, Wo, Gg, Gg, Gg, Gg, Gg, Gg, Hh, Gg, Gg
Wo, Wo, Wo, Wo, Wo, Gg, Gg, Gg, Hh, Rd, Hh^Fms, Rd, Mm, Gg, Gg, Gg, Gg^Vh, Wwf, Gg, Mm, Ww, Wo, Gg, Hh, Gg, Gg, Gs^Fms, Gg, Gg, Wwf^Bw\, Ch, Gg, Gg, Gg, Gg, Gg, Xos, Xos, Gs^Fdf, Hh, Hh, Wo, Wo, Mm, Hh^Fmw, Gg, Hh^Fmw, Gg, Gg, Gg, Gg
Wo, Wo, Wo, Wo, Wo, Wo, Wo, Hh, Hh^Fms, Wwf, Wwf, Wwf, Gg, Gg, Gg, Gg, Gg, Ww, Wo, Ww, Mm, Gg, Gg, Gg, Gg, Gg, Gg, Gg, Ww, Ww, Gg, Gg, Gg, Gg, Gg, Gg, Xol, Xol, Gs^Fdf, Gs^Fdf, Gg, Hh, Wo, Gg, Gg, Hh^Fmw, Hh, Gg, Gg, Gg, Gg
Wo, Wo, Wo, Wo, Wo, Wo, Gg, Gg, Chw, Wwf, Gg, Chw, Gg, Gg, Wo, Wo, Wo, Wo, Gg, Gg, Wwf, Gg, Gs^Fms, Gg, Gg, Gg, Wo, Wwf, Wo, Gg, Gg, Hh, Uu^Vu, Hh, Gg, Xol, Mm, Wo, Wo, Gg^Ve, Gg, Wo, Gs^Fdf, Hh^Fmw, Hh^Fmw, Gg, Gg, Gg, Gg, Gg, Gg
Wo, Wo, Wo, Wo, Wo, Wo, Ww, Gg^Vh, Ww, Gg, Gg, Gg, Wo, Wo, Gg, Gg, Hh, Gg, Hh^Fms, Wwf, Hh, Gg^Vh, Ww, Gg, Wo, Wo, Gg, Wo, Gg, Gg, Gg, Gg, Gg, Gg, Mm, Mm, Mm, Gs^Fdf, Gg, Ww, Wwf^Bw|, Ww, Wo, Gs^Fdf, Gg, Gg, Gg, Gg, Cv, Gg, Gg
Wo, Wo, Wo, Wo, Wo, Wo, Wo, Chw, Wo, Wo, Wo, Wo, Mm, Mm, Gg, Gg, Uu^Vu, Wwf, Hh^Fms, Gg, Gg, Gg, Ww, Wo, Gg, Gg, Hh, Gg, Gs^Fms, Ch, Gs^Fms, Gg, Hh, Gg, Xol, Xol, Mm, Gs^Fdf, Gg, Gs^Fdf, Gg, Gg, Wo, Gg^Ve, Gs^Fdf, Gg, Ch, Gg, Gg, Gg, Gg
Wo, Wo, Wo, Wo, Wo, Wo, Ww, Ss, Wo, Wo, Wo, Wo, Wwf, Gg, Gg, Hh, Wwf, Gg, Hh, Hh, Gg, Gg, Wo, Ww, Gg, Wwf, Gg^Vh, Gg, Xol, Gs^Fms, Gs^Fms, Hh, Xol, Xol, Mm, Mm, Gs^Fms, Gs^Fms, Gs^Fms, Gg, Gg, Gg, Gs^Fds, Wo, Wo, Hh, Re, Hh, Gg, Gg, Gg
Wo, Wo, Wo, Wo, Hh^Fp, Ww, Ww, Wo, Wo, Wo, Ww, Ww, Wwf, Wwf, Wo, Ss, Hh, Gg, Ww, Gg, Wo, Wo, Gg, Hh, Gg, Gs^Fms, Xol, Xol, Ur, Xol, Xol, Mm, Mm, Mm, Mm, Gs^Fms, Gg^Fet, Gs^Fms, Gg, Gg^Ve, Gs^Fms, Gg, Wo, Gg^Fet, Gg, Wo, Re, Re, Re, Re, Gg
Wo, Wo, Wo, Wo, Rd, Gg^Ve, Wwf, Wo, Wo, Wo, Ww, Ww, Ww, Mm, Gg, Hh, Wo, Ww, Gg, Wo, Gg, Hh, Gg^Vh, Wwf, Gg, Xol, Ur, Ur, Ur, Uu^Vu, Ww, Xol, Gs^Fds, Mm, Gg, Gs^Fds, Cv, Gs^Fds, Gg, Gg, Gs^Fms, Gs^Fds, Gg, Wo, Wo, Wo, Re, Gg^Vh, Re, Gg, Gg
Wo, Wo, Wo, Rd, Gs^Ft, Gg, Wo, Wo, Wo, Wo, Ww, Wo, Ww, Mm, Wo, Wo, Hh, Hh^Fms, Gg, Gg, Wwf, Wwf, Gs^Fms, Gg, Ch, Ur, Ur, Ur, Ww, Ww, Xol, Xol, Gs^Fms, Gs^Fds, Gg, Gg, Gg, Gg, Gg, Gs^Fms, Gg, Gg, Gg, Gg, Wo, Wwf, Re, Re, Hh, Re, Gg
Wo, Wo, Wo, Rd, Wo, Wo, Wo, Wo, Wo, Wo, Wo, Wo, Ww, Wo, Mm, Mm, Gg, Gg, Gg^Ve, Wwf, Hh^Fms, Gg, Gg, Gg, Ww, Gg, Gg, Uu^Vu, Ww, Wo, Wo, Gg, Gg, Gg, Gg^Vh, Gg, Gg, Wo, Wwf, Gg, Gg, Gg, Wo, Wo, Gg, Gg, Re, Re, Re, Gg, Gg
Wo, Wo, Gs^Ft, Gs^Ft, Gs^Ft, Wo, Wo, Wo, Wo, Wo, Wo, Wo, Ww, Ww, Wwf, Gg, Gg, Wwf, Gg, Gs^Fms, Gg, Gg, Ww, Ww, Gg, Ww, Ww, Wwf, Gg, Wo, Gg, Gg, Gg, Gg, Gg, Gg, Gg, Wo, Gg, Gg^Vh, Gg, Ww, Gg, Gg, Gg, Gg, Gg, Gg, Gg, Gg, Gg
Wo, Wo, Gs^Ft, Gg^Ve, Gg, Wo, Ww, Wo, Wo, Wo, Wo, Wo, Ww, Ww, Wwf, Wwf, Hh, Rd, Gg, Gg, Ww, Ww, Gg, Gg, Xol, Gg, Gg, Gg, Gg, Gg, Re^Gvs, Ch, Gg, Gg, Ww, Ww, Ww, Ww, Gg, Gg, Ww, Wwf^Bw\, Gg, Ch, Gs, Ss, Gg, Gs, Gg, Gs, Gg
Wo, Wo, Ss, Rd, Gs^Fms, Gg, Wo, Wo, Wo, Wo, Wo, Ww, Wo, Ww, Mm, Hh, Ww, Rd, Ww, Ww, Ww, Gg, Gg, Xol, Gg^Vh, Gg, Mm, Gg, Gg, Gg, Gg, Re^Gvs, Gg, Ww, Gg, Gg, Gg, Gg, Gg, Gg, Ww, Gg, Ss, Gs, Ss, Gs, Gs, Ss^Vhs, Gs, Gg, Gg
Wo, Wo, Wo, Rd, Rd, Wo, Wo, Wo, Wo, Wo, Wo, Wo, Wo, Ww, Wo, Wo, Gg, Wwf, Gg, Gg, Mm, Ww, Xol, Xol, Xol, Mm, Xol, Gg, Gg, Gg^Vh, Gg, Gg, Wwf, Wwf, Ww, Gg, Gg, Gg, Ww, Ww, Gg, Gg, Gg, Gs, Ss, Gs, Gs, Gg, Gs, Ss, Ss
Wo, Wo, Gs^Ft, Gs^Ft, Gg^Ve, Gs^Ft, Wo, Wo, Wo, Wo, Wo, Wo, Wo, Wo, Gg, Gg, Gg, Hh, Hh, Hh, Mm, Xol, Hh, Hh, Gg, Xol, Mm, Hh^Fms, Gs^Fms, Rd, Rd, Gg, Rd, Gg, Gg, Wo, Wo, Ww, Gg, Gg, Gg, Gs, Gg, Gg, Gg, Gg, Ss, Gg, Xol, Xol, Xol
Wo, Wo, Wo, Gg, Md, Wwf, Ww, Wo, Wo, Wo, Wo, Wo, Wo, Wo, Gg, Gg, Mm, Ch, Hh, Xol, Gg, Mm, Gg, Gg, Gg^Vh, Gg, Mm, Xol, Xol, Xol, Xol, Rd, Xol, Rd, Rd, Gg, Wo, Gg, Gg, Gg, Gg, Gg, Uu, Uu, Uu, Uu, Xol, Xol, Ur, Cud, Uu
Wo, Wo, Wo, Wo, Wo, Wo, Ww, Wo, Wo, Wo, Wo, Wo, Gg, Gg, Hh, Hh, Hh, Hh, Gg, Gg, Gg, Gg^Wm, Gg, Gg, Hh, Gg, Gg, Mm, Mm, Xol, Rr, Xol, Xol, Xol, Rd, Ch, Wo, Gg, Gs^Fdw, Gs^Fdw, Xol, Uu, Cud, Qlf, Qlf, Xol, Qlf, Ur, Ur, Uu^Vu, Cud
Wo, Wo, Wo, Wo, Wo, Wo, Wwf, Wo, Wo, Wo, Wo, Wo, Gg, Gg, Mm, Mm, Gg, Rd, Gg, Gg, Gg, Gg, Gg, Gg, Gg, Gg, Gg, Hh, Wo, Xol, Ch, Gg^Vh, Ch, Rd, Gg, Gg, Wo, Gg, Uu, Uh, Uh, Xol, Uu, Ur, Uu, Xol, Ur, Ql^Bs/, Qlf, Ur, Uh
Wo, Wo, Wo, Wo, Wo, Wo, Wo, Ww^Vm, Wwf, Wo, Wo, Gg, Hh, Xol, Gg, Gg, Ss, Rd, Rd, Gg, Gg, Gg, Gg, Gg, Gg, Hh^Fp, Gs^Fp, Gg, Wo, Xol, Gg, Ch, Gg, Rr, Rr, Gg, Ww, Gg, Uh, Xol, Ur, Ur, Uu^Vu, Ur, Uu, Ur, Ur, Ur, Ur, Ql^Bs|, Qlf
Wo, Wo, Wo, Wo, Wo, Wo, Wo, Wo, Wo, Ww, Ww, Gg, Gg, Gg, Gg, Ss, Hh, Gg, Wwr, Gg^Vh, Hh, Gg, Wwf, Hh, Gg^Vh, Hh^Fp, Gg, Gg, Wwf^Bw/, Gg, Gg, Gg, Gg, Gg, Ww, Chw, Ur, Uu, Ur, Xol, Ur, Ur, Ur, Ur, Qlf, Qlf, Ur, Uu^Vu, Ur, Ur, Ur
Wo, Wo, Wo, Wo, Wo, Wo, Wo, Wo, Wo, Ww, Wo, Ww, Wo, Gg, Gg, Gg, Gg, Gg, Gg, Wwf, Wwf, Wwf, Rd, Wwf, Wwf, Rd, Rd, Rd, Ww, Gg, Gg, Gg, Wo, Wo, Gg, Gg, Uu, Ur, Uh, Ur, Uu^Vu, Ur, Uu, Ur, Ur, Tb^Tf, Ur, Ur, Ql, Uu, Ur
Wo, Wo, Wo, Wo, Wo, Wo, Wo, Wo, Wo, Wo, Wo, Wo, Wo, Ww, Wwf, Gg, Gg, Gg, Hh, Wwf, Rd, Rd, Gg, Gg, Wwf, Gg, Rd, Gg, Wo, Ww, Wo, Gg, Wo, Gg, Gg, Gg^Vh, Uu, Xol, Ql, Uu, Ur, Ur, Ur, Uh, Ur, Ur, Ql^Bs\, Ql, Ur, Ql^Bs/, Ql
Wo, Wo, Wo, Wo, Wo, Wo, Wo, Wo, Wo, Wo, Wo, Wo, Wo, Ww, Wo, Gg, Wo, Gg, Gg^Vh, Wwf, Mm, Xol, Gg, Wwf, Gg, Gs^Fp, Gg^Ve, Wo, Gg, Gg, Wo, Wo, Gg^Vh, Hh, Hh^Fms, Gg, Uh, Xol, Xol, Uu, Ur, Qlf, Ur, Ur, Ur, Ql, Ur, Ur, Uu^Vu, Ur, Ql
Wo, Wo, Wo, Wo, Wo, Wo, Wo, Wo, Wo, Wo, Wo, Wo, Wo, Wo, Wo, Wo, Ww, Wwf, Wwf, Wwf, Gg, Gg, Gg, Wwf, Ww, Wwf, Wwr, Gg, Wo, Wo, Wo, Gg, Gs^Fms, Gg, Gs^Fms, Gs^Fdw, Uh, Xol, Xol, Uh, Ur, Ur, Cud, Uh, Ur, Ql^Bs/, Ql, Ur, Cud, Ur, Ql
Xv, Xv, Xv, Xv, Xv, Xv, Xv, Xv, Xv, Xv, Xv, Xv, Xv, Xv, Xv, Wo, Xv, Xv, Xv, Xv, Xv, Xv, Xv, Xv, Xv, Xv, Xv, Xv, Xv, Xv, Xv, Xv, Xv, Xv, Xv, Xv, Xv, Xv, Xv, Xv, Xv, Xv, Xv, Xv, Xv, Xv, Xv, Xv, Xv, Xv, Xv
Xv, Xv, Xv, Xv, Xv, Xv, Xv, Xv, Xv, Xv, Xv, Xv, Xv, Xv, Xv, Xv, Xv, Xv, Xv, Xv, Xv, Xv, Xv, Xv, Xv, Xv, Xv, Xv, Xv, Xv, Xv, Xv, Xv, Xv, Xv, Xv, Xv, Xv, Xv, Xv, Xv, Xv, Xv, Xv, Xv, Xv, Xv, Xv, Xv, Xv, Xv
Xv, Xv, Xv, Xv, Xv, Xv, Xv, Xv, Xv, Xv, Xv, Xv, Xv, Xv, Xv, Xv, Xv, Xv, Xv, Xv, Xv, Xv, Xv, Xv, Xv, Xv, Xv, Xv, Xv, Xv, Xv, Xv, Xv, Xv, Xv, Xv, Xv, Xv, Xv, Xv, Xv, 1 Xv, Xv, 2 Xv, Xv, 3 Xv, Xv, Xv, Xv, Xv, Xv
Xv, Xv, Xv, Xv, Xv, Xv, Xv, Xv, Xv, Xv, Xv, Xv, Xv, Xv, Xv, Xv, Xv, Xv, Xv, Xv, Xv, Xv, Xv, Xv, Xv, Xv, Xv, Xv, Xv, Xv, Xv, Xv, Xv, Xv, Xv, Xv, Xv, Xv, Xv, Xv, Xv, Xv, Xv, Xv, Xv, Xv, Xv, Xv, Xv, Xv, Xv
Xv, Xv, Xv, Xv, Xv, Xv, Xv, Xv, Xv, Xv, Xv, Xv, Xv, Xv, Xv, Xv, Xv, Xv, Xv, Xv, Xv, Xv, Xv, Xv, Xv, Xv, Xv, Xv, Xv, Xv, Xv, Xv, Xv, Xv, Xv, Xv, Xv, Xv, Xv, Xv, Xv, 4 Xv, Xv, 5 Xv, Xv, 6 Xv, Xv, Xv, Xv, Xv, Xv
Xv, Xv, Xv, Xv, Xv, Xv, Xv, Xv, Xv, Xv, Xv, Xv, Xv, Xv, Xv, Xv, Xv, Xv, Xv, Xv, Xv, Xv, Xv, Xv, Xv, Xv, Xv, Xv, Xv, Xv, Xv, Xv, Xv, Xv, Xv, Xv, Xv, Xv, Xv, Xv, Xv, Xv, Xv, Xv, Xv, Xv, Xv, Xv, Xv, Xv, Xv
Xv, Xv, Xv, Xv, Xv, Xv, Xv, Xv, Xv, Xv, Xv, Xv, Xv, Xv, Xv, Xv, Xv, Xv, Xv, Xv, Xv, Xv, Xv, Xv, Xv, Xv, Xv, Xv, Xv, Xv, Xv, Xv, Xv, Xv, Xv, Xv, Xv, Xv, Xv, Xv, Xv, Xv, Xv, Xv, Xv, Xv, Xv, Xv, Xv, Xv, Xv
