Wo, Wo, Wo, Wo, Wo, Wo, Wo, Wo, Wo, Wo, Wo, Wo, Wo, Wo, Wo, Wo, Wo, Wo, Wo, Wo, Ww, Wo, Ai, Ai, Aa, Aa, Aa, Aa, Aa, Aa, Aa, Aa, Aa, Aa, Aa, Aa, Aa, Aa, Aa, Aa, Aa, Aa, Aa, Aa, Aa, Aa, Aa, Aa, Aa, Aa, Aa
Wo, Wo, Wo, Wo, Ai, Wo, Wo, Wo, Wo, Ai, Wo, Ww, Wo, Wo, Wo, Ai, Wo, Wo, Wo, Wo, Ww, Wwf, Re^Vd, Re, Aa, Aa, Aa, Aa, Aa, Aa, Aa, Aa, Aa, Aa, Aa, Aa, Re, Aa, Aa, Aa, Aa, Aa, Re, Aa, Ms, Ms, Xos, Ms, Ms, Aa, Aa
Wo, Wo, Wo, Ai, Wo, Wo, Wo, Ww, Wo, Wo, Wwf, Ww, Hh, Wo, Wo, Wo, Wo, Wo, Ww, Wo, Wwf, Wwf, Re, Re, Re, Aa, Re, Aa, Aa, Aa, Aa, Aa, Aa, Aa, Aa, Re, Re^Vu, Hh, Re, Aa, Re, Re, Hh, Re^Vu, Re, Xos, Re, Xos, Aa, Aa, Aa
Wo, Wo, Wo, Wo, Wo, Wo, Wo, Wo, Ww, Wwf, Hh, Mm^Vhh, Hh, Ai, Wo, Wo, Ww, Ai, Ai, Ww, Ms, Ms, Ms, Aa, Ms, Re, Re, Aa, Re, Re, Hh, Aa, Re, Ch, Re, Re, Hh, Re, Aa, Re, Ms, Re, Re, Ms, Xos, Re, Re, Aa, Gg, Aa, Gg
Wo, Wo, Wo, Wo, Ai, Wo, Wo, Wo, Xos, Ms, Re, Mm, Re, Wo, Wwf, Wwf, Ww, Wo, Ai, Ai, Aa, Gg, Ha, Ms, Ms, Ha, Aa, Re, Re, Re^Vu, Re, Re, Hh, Re, Hh, Re, Xos, Xos, Mm, Xos, Mm, Xos, Xos, Xos, Xos, Hh, Xos, Gg, Gg, Gg, Gg
Wo, Wo, Wo, Wo, Wo, Wo, Xos, Xos, Ai, Ai, Re, Ch, Hh, Re, Re, Re^Vu, Wwf, Ai, Aa, Aa, Gg, Gg, Gg, Aa, Ms, Ha, Re, Re, Aa, Re, Xos, Xos, Xos, Xos, Xos, Xos, Gg, Xos, Gg, Mm, Gg, Gg, Gg, Gg, Gg, Gg, Gg, Xos, Mm, Gg, Gg
Wo, Wo, Wo, Wo, Wo, Wo, Gg, Gg, Re, Re, Hh, Hh, Ms, Ha, Aa, Re, Wwf, Aa, Gg, Gg, Aa, Gg, Ch, Gg, Gg, Hh, Mm, Mm, Mm, Gg, Gg, Xos, Gg, Mm, Gg, Gg, Gs^Fds, Gg, Gg, Wo, Wo, Wo, Wo, Gs^Fds, Gs^Fds, Gg, Gg, Gg, Gg, Gg, Gg
Wo, Wo, Wo, Wo, Wo, Wo, Gg, Ch, Xos, Mm, Xos, Mm, Xos, Xos, Gg, Aa, Chw, Gg, Gg, Gg, Gg, Gg, Wo, Wo, Gg, Hh, Xos, Mm, Xos, Gg, Gg, Gg, Gg, Hh^Fms, Gg, Gg, Gg, Gg, Gg, Gs^Fds, Gs^Fds, Gs^Fds, Ww, Gs^Fds, Gg, Gg, Gg, Hh^Vhh, Gg, Gg, Gg
Wo, Wo, Wwf, Wwf, Gg, Gg, Gs^Fds, Gg, Gg, Xos, Gg, Xos, Hh, Hh, Gg, Gg, Wwf, Gg, Gg, Gg, Gg, Wo, Wo, Wo, Gg, Xos, Gg, Mm, Xos, Hh, Wwf, Wo, Wo, Gg, Gg, Ch, Gg, Gs^Fds, Gg, Gs^Fds, Gg, Hh^Fms, Gs^Fds, Wwf, Ww, Ww, Ww, Mm, Gs^Fds, Gg, Gg
Wo, Wo, Wwf, Wwf, Gg, Gg, Gg, Gg, Wo, Gs^Fds, Gg^Vh, Rd, Rd, Hh^Fms, Wwf, Wwf, Hh, Gg, Gg, Hh, Gg, Wo, Wo, Wo, Wwf, Gg, Gg, Gg, Mm, Xos, Xos, Hh, Gg, Wo, Wo, Gg, Gg, Gg, Gg, Gg, Gg^Ve, Gs^Fds, Gs^Fds, Gs^Fds, Wo, Wo, Gg^Vh, Wwf, Gs^Fds, Gg, Gg
Wo, Wo, Ww, Gg^Ve, Gg, Wo, Wo, Wo, Wo, Wwf, Ww, Wwf, Wwf, Wwf, Hh, Rd, Gg, Gg, Gg, Hh, Gg, Gg, Wo^Bw/, Gg, Gg, Rd^Vh, Gg, Gg, Ww, Ww, Xos, Mm, Gs, Gg, Gg, Wo, Ww, Mm, Hh^Fms, Xos, Mm, Mm, Gs^Fds, Gs^Fds, Gs^Fds, Wo, Wo, Wo, Wo, Gg, Gg
Wo, Wo, Wo, Wwf, Ww, Ww, Wo, Wo, Wo, Wo, Wo, Wo, Gg, Hh, Gg, Rd, Rd^Vh, Rd, Rd, Ch, Rd, Rd, Ww, Gg, Rd, Rd, Rd, Ww, Wwf, Gg^Ve, Rd, Xos, Mm, Mm, Rd, Rd, Wwf^Bw/, Rd, Rd, Rd, Rd, Rd, Rd, Rd, Rd, Rd, Rd, Rd, Ww, Ww, Rd
Wo, Wo, Wo, Wo, Wo, Ww, Wwf, Ww, Gs^Fds, Gg, Rd, Rd, Rd, Ch, Rd, Rd, Rd, Gg, Hh, Gg, Gg, Wo^Bw\, Rd, Rd, Gg, Gg, Gg, Wo^Bw\, Rd, Rd, Hh^Fdf, Rd, Rd, Mm, Xos, Gg, Gg, Ww, Wo, Gg, Gg, Cv, Gg, Gg, Gs^Fds, Gs^Fds, Gs^Fds, Gs^Fds, Gg, Wwf, Ww
Wo, Wo, Wo, Wo, Wo, Ww, Hh, Gs^Fds, Rd^Ve, Rd, Mm, Gg, Gg, Rd, Hh^Fms, Gg, Gg, Rd, Rd, Gg, Gg, Wo, Gs^Fds, Rd^Vh, Gg, Gg, Gg, Ww, Gg, Hh^Fdf, Gg, Gg, Mm, Xos, Xos, Mm, Hh, Gg, Wo, Gg, Gs^Fds, Gg, Hh^Fms, Hh^Fms, Gs^Fds, Gg, Gg, Gs^Fds, Gs^Fds, Gg, Gg
Wo, Wo, Wo, Wo, Wo, Gg, Gg, Gg, Mm, Gg, Mm, Mm, Xos, Gg, Gg, Gg, Hh^Fms, Hh^Fms, Rd, Gg, Gg, Wo, Rd, Gg, Gg, Hh^Fms, Gg, Wo, Ww, Gg, Gg, Gg, Gg, Mm, Mm, Xos, Hh, Gg, Ww, Gg^Ve, Gg, Gs^Fds, Gs^Fds, Gs^Fds, Gg, Gg^Ve, Gs^Fds, Gs^Fds, Gg, Gs^Fds, Gg
Wo, Wo, Wo, Gg, Gg, Gg, Ch, Hh^Fms, Mm, Mm, Xos, Xos, Hh, Gg, Gg, Gg, Hh^Fms, Gg, Rd, Gg, Rd, Chw, Gg, Rd, Ch, Gg, Hh^Fms, Gg, Gg, Ww, Gg, Gg^Vh, Hh, Gg, Hh, Xos, Xos, Hh, Gg, Ww, Wo, Gs^Fds, Gg, Gs^Fdw, Gs^Fds, Gg, Gs^Fds, Gg, Gg, Gg, Gg
Wo, Wo, Ww, Gg, Gs^Fds, Gg, Hh^Fms, Mm, Mm, Xos, Xos, Xos, Hh, Hh, Gg, Gg, Gg, Gg, Rd, Rd, Gg, Wo, Wo, Gg, Gg, Rd, Gg, Hh^Fms, Gg, Ww, Ww, Gg, Gg, Gg, Gg, Md^Xm, Xos, Mm, Mm, Gg, Gs^Fmw, Wo, Gs^Fdw, Gs^Fdw, Gs^Fdw, Gs^Fds, Gs^Fds, Gg^Ve, Gg, Gg, Gg
Wo, Wo, Ww, Gg^Ve, Gg, Gg, Mm, Mm, Xos, Xos, Mm, Mm, Mm, Hh, Hh^Fms, Gg, Gg, Hh, Rd^Vh, Wwf, Gg, Hh, Gg, Wo, Gg, Rd, Gg, Gg, Gg, Gg, Wo, Gg, Gg, Gg, Gg^Vu, Mm, Xos, Xos, Ur, Gg, Ww, Wo, Ur, Ur, Ur, Gs^Fmw, Hh^Fmw, Gg, Gs^Fds, Gg, Gg
Wo, Wo, Wo, Wwf, Hh^Fms, Hh, Hh^Fms, Mm, Xos, Xos, Mm, Mm, Hh, Gg, Gg, Gg, Rd, Rd, Gg, Wwf, Wwf, Gg, Gg, Wo, Gg, Rd^Vh, Rd, Gg, Gg, Gg, Ww, Gg, Gg, Hh, Gg, Xos, Hh, Ur, Ur, Gg, Wwf^Bw/, Gs^Fmw, Ur, Ur^Vu, Ur, Gs^Fmw, Hh^Fmw, Hh^Fmw, Gg, Gg, Gg
Wo, Wo, Wo, Wo, Gg, Hh^Fms, Gg, Xos, Gg^Vh, Hh, Mm, Mm, Rd^Vh, Ch, Rd, Rd, Hh^Fms, Gg, Gg, Gg, Wwf, Ww, Wo, Wo, Gg, Gs^Fms, Rd, Gg, Gg, Gg, Ww, Gg, Gs^Fms, Gg, Gg, Xos, Ur, Ur^Vu, Xos, Gg, Gg, Ww, Gg, Hh, Gg, Hh, Gs^Fds, Gs^Fds, Gg, Gg, Gg
Wo, Wo, Wo, Wo, Wo, Wo, Gg, Gg, Wwf, Mm, Mm, Chw, Mm, Rd, Gg, Gg, Gg, Gg, Gg, Gg, Wo, Wo, Gg, Gg, Gg^Ve, Gs^Fds, Gg, Rd, Ch, Gg, Ww, Gg, Gs^Fms, Gs^Fms, Ch, Gg, Ur, Ur, Xos, Gg, Gg, Wo, Gg, Gg, Gg, Gg, Gg, Gg, Hh, Gg, Gg
Wo, Wo, Wo, Wo, Wo, Gg, Gg, Gg, Hh, Rd, Hh^Fms, Rd, Mm, Gg, Gg, Gg, Gg^Vh, Wwf, Gg, Mm, Ww, Wo, Gg, Hh, Gg, Gg, Gs^Fms, Gg, Gg, Wwf^Bw\, Ch, Gg, Gg, Gg, Gg, Gg, Xos, Xos, Gs^Fdf, Hh, Hh, Wo, Wo, Mm, Hh^Fmw, Gg, Hh^Fmw, Gg, Gg, Gg, Gg
Wo, Wo, Wo, Wo, Wo, Wo, Wo, Hh, Hh^Fms, Wwf, Wwf, Wwf, Gg, Gg, Gg, Gg, Gg, Ww, Wo, Ww, Mm, Gg, Gg, Gg, Gg, Gg, Gg, Gg, Ww, Ww, Gg, Gg, Gg, Gg, Gg, Gg, Xos, Xos, Gs^Fdf, Gs^Fdf, Gg, Hh, Wo, Gg, Gg, Hh^Fmw, Hh, Gg, Gg, Gg, Gg
Wo, Wo, Wo, Wo, Wo, Wo, Gg, Gg, Chw, Wwf, Gg, Chw, Gg, Gg, Wo, Wo, Wo, Wo, Gg, Gg, Wwf, Gg, Gs^Fms, Gg, Gg, Gg, Wo, Wwf, Wo, Gg, Gg, Hh, Gg^Vu, Hh, Gg, Xos, Mm, Wo, Wo, Gg^Ve, Gg, Wo, Gs^Fdf, Hh^Fmw, Hh^Fmw, Gg, Gg, Gg, Gg, Gg, Gg
Wo, Wo, Wo, Wo, Wo, Wo, Ww, Gg^Vh, Ww, Gg, Gg, Gg, Wo, Wo, Gg, Gg, Hh, Gg, Hh^Fms, Wwf, Hh, Gg^Vh, Ww, Gg, Wo, Wo, Gg, Wo, Gg, Gg, Gg, Gg, Gg, Gg, Mm, Mm, Mm, Gs^Fdf, Gg, Ww, Wwf^Bw|, Ww, Wo, Gs^Fdf, Gg, Gg, Gg, Gg, Cv, Gg, Gg
Wo, Wo, Wo, Wo, Wo, Wo, Wo, Chw, Wo, Wo, Wo, Wo, Mm, Mm, Gg, Gg, Gg^Vu, Wwf, Hh^Fms, Gg, Gg, Gg, Ww, Wo, Gg, Gg, Hh, Gg, Gs^Fms, Ch, Gs^Fms, Gg, Hh, Gg, Xos, Xos, Mm, Gs^Fdf, Gg, Gs^Fdf, Gg, Gg, Wo, Gg^Ve, Gs^Fdf, Gg, Ch, Gg, Gg, Gg, Gg
Wo, Wo, Wo, Wo, Wo, Wo, Ww, Ss, Wo, Wo, Wo, Wo, Wwf, Gg, Gg, Hh, Wwf, Gg, Hh, Hh, Gg, Gg, Wo, Ww, Gg, Wwf, Gg^Vh, Gg, Xos, Gs^Fms, Gs^Fms, Hh, Xos, Xos, Mm, Mm, Gs^Fms, Gs^Fms, Gs^Fms, Gg, Gg, Gg, Gs^Fds, Wo, Wo, Hh, Re, Hh, Gg, Gg, Gg
Wo, Wo, Wo, Wo, Hh^Fp, Ww, Ww, Wo, Wo, Wo, Ww, Ww, Wwf, Wwf, Wo, Ss, Hh, Gg, Ww, Gg, Wo, Wo, Gg, Hh, Gg, Gs^Fms, Xos, Xos, Ur, Xos, Xos, Mm, Mm, Mm, Mm, Gs^Fms, Gg^Fet, Gs^Fms, Gg, Gg^Ve, Gs^Fms, Gg, Wo, Gg^Fet, Gg, Wo, Re, Re, Re, Re, Gg
Wo, Wo, Wo, Wo, Rd, Gg^Ve, Wwf, Wo, Wo, Wo, Ww, Ww, Ww, Mm, Gg, Hh, Wo, Ww, Gg, Wo, Gg, Hh, Gg^Vh, Wwf, Gg, Xos, Ur, Ur, Ur, Ur^Vu, Ww, Xos, Gs^Fds, Mm, Gg, Gs^Fds, Cv, Gs^Fds, Gg, Gg, Gs^Fms, Gs^Fds, Gg, Wo, Wo, Wo, Re, Gg^Vh, Re, Gg, Gg
Wo, Wo, Wo, Rd, Gs^Ft, Gg, Wo, Wo, Wo, Wo, Ww, Wo, Ww, Mm, Wo, Wo, Hh, Hh^Fms, Gg, Gg, Wwf, Wwf, Gs^Fms, Gg, Ch, Ur, Ur, Ur, Ww, Ww, Xos, Xos, Gs^Fms, Gs^Fds, Gg, Gg, Gg, Gg, Gg, Gs^Fms, Gg, Gg, Gg, Gg, Wo, Wwf, Re, Re, Hh, Re, Gg
Wo, Wo, Wo, Rd, Wo, Wo, Wo, Wo, Wo, Wo, Wo, Wo, Ww, Wo, Mm, Mm, Gg, Gg, Gg^Ve, Wwf, Hh^Fms, Gg, Gg, Gg, Ww, Gg, Gg, Ur^Vu, Ww, Wo, Wo, Gg, Gg, Gg, Gg^Vh, Gg, Gg, Wo, Wwf, Gg, Gg, Gg, Wo, Wo, Gg, Gg, Re, Re, Re, Gg, Gg
Wo, Wo, Gs^Ft, Gs^Ft, Gs^Ft, Wo, Wo, Wo, Wo, Wo, Wo, Wo, Ww, Ww, Wwf, Gg, Gg, Wwf, Gg, Gs^Fms, Gg, Gg, Ww, Ww, Gg, Ww, Ww, Wwf, Gg, Wo, Gg, Gg, Gg, Gg, Gg, Gg, Gg, Wo, Gg, Gg^Vh, Gg, Ww, Gg, Gg, Gg, Gg, Gg, Gg, Gg, Gg, Gg
Wo, Wo, Gs^Ft, Rd^Ve, Gg, Wo, Ww, Wo, Wo, Wo, Wo, Wo, Ww, Ww, Wwf, Wwf, Hh, Rd, Gg, Gg, Ww, Ww, Gg, Gg, Xos, Gg, Gg, Gg, Gg, Gg, Re^Gvs, Ch, Gg, Gg, Ww, Ww, Ww, Ww, Gg, Gg, Ww, Wwf^Bw\, Gg, Ch, Gs, Ss, Gg, Gs, Gg, Gs, Gg
Wo, Wo, Ss, Rd, Gs^Fms, Gg, Wo, Wo, Wo, Wo, Wo, Ww, Wo, Ww, Mm, Hh, Ww, Rd, Ww, Ww, Ww, Gg, Gg, Xos, Gg^Vh, Gg, Mm, Gg, Gg, Gg, Gg, Re^Gvs, Gg, Ww, Gg, Gg, Gg, Gg, Gg, Gg, Ww, Gg, Ss, Gs, Ss, Gs, Gs, Ss^Vhs, Gs, Gg, Gg
Wo, Wo, Wo, Rd, Rd, Wo, Wo, Wo, Wo, Wo, Wo, Wo, Wo, Ww, Wo, Wo, Gg, Wwf, Gg, Gg, Mm, Ww, Xos, Xos, Xos, Mm, Xos, Gg, Gg, Gg^Vh, Gg, Gg, Wwf, Wwf, Ww, Gg, Gg, Gg, Ww, Ww, Gg, Gg, Gg, Gs, Ss, Gs, Gs, Gg, Gs, Ss, Ss
Wo, Wo, Gs^Ft, Gs^Ft, Gg^Ve, Gs^Ft, Wo, Wo, Wo, Wo, Wo, Wo, Wo, Wo, Gg, Gg, Gg, Hh, Hh, Hh, Mm, Xos, Hh, Hh, Gg, Xos, Mm, Hh^Fms, Gs^Fms, Rd, Rd, Gg, Rd, Gg, Gg, Wo, Wo, Ww, Gg, Gg, Gg, Gs, Gg, Gg, Gg, Gg, Ss, Gg, Xos, Xos, Xos
Wo, Wo, Wo, Gg, Md, Wwf, Ww, Wo, Wo, Wo, Wo, Wo, Wo, Wo, Gg, Gg, Mm, Ch, Hh, Xos, Gg, Mm, Gg, Gg, Gg^Vh, Gg, Mm, Xos, Xos, Xos, Xos, Rd, Xos, Rd, Rd, Gg, Wo, Gg, Gg, Gg, Gg, Gg, Uu, Uu, Uu, Uu, Xos, Xos, Ur, Cud, Uu
Wo, Wo, Wo, Wo, Wo, Wo, Ww, Wo, Wo, Wo, Wo, Wo, Gg, Gg, Hh, Hh, Hh, Hh, Gg, Gg, Gg, Gg^Wm, Gg, Gg, Hh, Gg, Gg, Mm, Mm, Xos, Rr, Xos, Xos, Xos, Rd, Ch, Wo, Gg, Gs^Fdw, Gs^Fdw, Xos, Uu, Cud, Qlf, Qlf, Xos, Qlf, Ur, Ur, Uu^Vu, Cud
Wo, Wo, Wo, Wo, Wo, Wo, Wwf, Wo, Wo, Wo, Wo, Wo, Gg, Gg, Mm, Mm, Gg, Rd, Gg, Gg, Gg, Gg, Gg, Gg, Gg, Gg, Gg, Hh, Wo, Xos, Ch, Rr^Vh, Ch, Rd, Gg, Gg, Wo, Gg, Uu, Uh, Uh, Xos, Uu, Ur, Uu, Xos, Ur, Ql^Bs/, Qlf, Ur, Uh
Wo, Wo, Wo, Wo, Wo, Wo, Wo, Ww^Vm, Wwf, Wo, Wo, Gg, Hh, Xos, Gg, Gg, Ss, Rd, Rd, Gg, Gg, Gg, Gg, Gg, Gg, Hh^Fp, Gs^Fp, Gg, Wo, Xos, Gg, Ch, Gg, Rr, Rr, Gg, Ww, Gg, Uh, Xos, Ur, Ur, Uu^Vu, Ur, Uu, Ur, Ur, Ur, Ur, Ql^Bs|, Qlf
Wo, Wo, Wo, Wo, Wo, Wo, Wo, Wo, Wo, Ww, Ww, Gg, Gg, Gg, Gg, Ss, Hh, Gg, Wwr, Gg^Vh, Hh, Gg, Wwf, Hh, Gg^Vh, Hh^Fp, Gg, Gg, Wwf^Bw/, Gg, Gg, Gg, Gg, Gg, Ww, Chw, Ur, Uu, Ur, Xos, Ur, Ur, Ur, Ur, Qlf, Qlf, Ur, Uu^Vu, Ur, Ur, Ur
Wo, Wo, Wo, Wo, Wo, Wo, Wo, Wo, Wo, Ww, Wo, Ww, Wo, Gg, Gg, Gg, Gg, Gg, Gg, Wwf, Wwf, Wwf, Rd, Wwf, Wwf, Rd, Rd, Rd, Ww, Gg, Gg, Gg, Wo, Wo, Gg, Gg, Uu, Ur, Uh, Ur, Uu^Vu, Ur, Uu, Ur, Ur, Tb^Tf, Ur, Ur, Ql, Uu, Ur
Wo, Wo, Wo, Wo, Wo, Wo, Wo, Wo, Wo, Wo, Wo, Wo, Wo, Ww, Wwf, Gg, Gg, Gg, Hh, Wwf, Rd, Rd, Gg, Gg, Wwf, Gg, Rd, Gg, Wo, Ww, Wo, Gg, Wo, Gg, Gg, Gg^Vh, Uu, Xos, Ql, Uu, Ur, Ur, Ur, Uh, Ur, Ur, Ql^Bs\, Ql, Ur, Ql^Bs/, Ql
Wo, Wo, Wo, Wo, Wo, Wo, Wo, Wo, Wo, Wo, Wo, Wo, Wo, Ww, Wo, Gg, Wo, Gg, Gg^Vh, Wwf, Mm, Xos, Gg, Wwf, Gg, Gs^Fp, Gg^Ve, Wo, Gg, Gg, Wo, Wo, Gg^Vh, Hh, Hh^Fms, Gg, Uh, Xos, Xos, Uu, Ur, Qlf, Ur, Ur, Ur, Ql, Ur, Ur, Uu^Vu, Ur, Ql
Wo, Wo, Wo, Wo, Wo, Wo, Wo, Wo, Wo, Wo, Wo, Wo, Wo, Wo, Wo, Wo, Ww, Wwf, Wwf, Wwf, Gg, Gg, Gg, Wwf, Ww, Wwf, Wwr, Gg, Wo, Wo, Wo, Gg, Gs^Fms, Gg, Gs^Fms, Gs^Fdw, Uh, Xos, Xos, Uh, Ur, Ur, Cud, Uh, Ur, Ql^Bs/, Ql, Ur, Cud, Ur, Ql
Xv, Xv, Xv, Xv, Xv, Xv, Xv, Xv, Xv, Xv, Xv, Xv, Xv, Xv, Xv, Wo, Xv, Xv, Xv, Xv, Xv, Xv, Xv, Xv, Xv, Xv, Xv, Xv, Xv, Xv, Xv, Xv, Xv, Xv, Xv, Xv, Xv, Xv, Xv, Xor, Xor, Xor, Xor, Xor, Xor, Xor, Xor, Xor, Xor, Xor, Xv
Xv, Xv, Xv, Xv, Xv, Xv, Xv, Xv, Xv, Xv, Xv, Xv, Xv, Xv, Xv, Xv, Xv, Xv, Xv, Xv, Xv, Xv, Xv, Xv, Xv, Xv, Xv, Xv, Xv, Xv, Xv, Xv, Xv, Xv, Xv, Xv, Xv, Xv, Xv, Xv, Xv, Xv, Xv, Xv, Xv, Xv, Xv, Xv, Xv, Xv, Xv
Xv, Xv, Xv, Xv, Xv, Xv, Xv, Xv, Xv, Xv, Xv, Xv, Xv, Xv, Xv, Xv, Xv, Xv, Xv, Xv, Xv, Xv, Xv, Xv, Xv, Xv, Xv, Xv, Xv, Xv, Xv, Xv, Xv, Xv, Xv, Xv, Xv, Xv, Xv, Xv, Xv, 1 Xv, Xv, 2 Xv, Xv, 3 Xv, Xv, Xv, Xv, Xv, Xv
Xv, Xv, Xv, Xv, Xv, Xv, Xv, Xv, Xv, Xv, Xv, Xv, Xv, Xv, Xv, Xv, Xv, Xv, Xv, Xv, Xv, Xv, Xv, Xv, Xv, Xv, Xv, Xv, Xv, Xv, Xv, Xv, Xv, Xv, Xv, Xv, Xv, Xv, Xv, Xv, Xv, Xv, Xv, Xv, Xv, Xv, Xv, Xv, Xv, Xv, Xv
Xv, Xv, Xv, Xv, Xv, Xv, Xv, Xv, Xv, Xv, Xv, Xv, Xv, Xv, Xv, Xv, Xv, Xv, Xv, Xv, Xv, Xv, Xv, Xv, Xv, Xv, Xv, Xv, Xv, Xv, Xv, Xv, Xv, Xv, Xv, Xv, Xv, Xv, Xv, Xv, Xv, 4 Xv, Xv, 5 Xv, Xv, 6 Xv, Xv, Xv, Xv, Xv, Xv
Xv, Xv, Xv, Xv, Xv, Xv, Xv, Xv, Xv, Xv, Xv, Xv, Xv, Xv, Xv, Xv, Xv, Xv, Xv, Xv, Xv, Xv, Xv, Xv, Xv, Xv, Xv, Xv, Xv, Xv, Xv, Xv, Xv, Xv, Xv, Xv, Xv, Xv, Xv, Xv, Xv, Xv, Xv, Xv, Xv, Xv, Xv, Xv, Xv, Xv, Xv
