Wo, Wo, Wwr, Ds, Mm, Hh, Mm, Hh, Md, Md, Ds, Wwf, Wwf, Wo, Wo, Wo, Wo, Wo, Wo, Wo, Wo, Wo, Wo, Wo, Wo, Wo, Wo, Wo, Wo, Wo, Wo, Wo, Wo, Wo, Wo, Wo, Wo, Wo, Wo, Wo, Wo, Wo, Wo, Wo, Wo, Wo, Wo, Wo, Wo, Wo, Wo, Wo, Wo, Wo, Wo, Wo, Wo, Ww, Ds, Gs, Gs, Gs
Wo, Wo, Wwr, Wo, Wo, Hhd^Vhh, Rr, Mm, Dd, Ds, Mm, Mm, Mm, Wo, Wo, Wo, Wo, Wo, Wo, Wo, Wo, Wo, Wo, Wo, Ww, Ww, Ww, Wo, Ww, Wo, Wwr, Wwr, Wwr, Wo, Wo, Wo, Wo, Wo, Wo, Wo, Wo, Wo, Wo, Wo, Wo, Wo, Wo, Wo, Wo, Wo, Wo, Wo, Wo, Wo, Wo, Wo, Wo, Ww, Ww, Dd^Do, Ds, Gs
Wo, Wo, Wwr, Wwr, Wo, Mm, Mm, Dd, Mm, Mm, Rr, Rr, Mm, Wwr, Wo, Wo, Wo, Wo, Wo, Wo, Wwr, Wo, Wwr, Ww, Wwr, Wwr, Wwr, Ww, Wo, Wwr, Wo, Wo, Wo, Wo, Wo, Wo, Wo, Wo, Wo, Wo, Wo, Ww, Wwr, Wo, Wo, Wo, Wo, Wo, Wwr, Wwr, Wo, Wo, Wo, Wo, Wo, Wo, Wo, Wo, Wo, Ww, Ww, Ds
Wo, Wo, Wo, Wo, Wo, Wo, Wo, Mm, Mm, Mm, Wo, Hhd^Vhh, Wo, Wwr, Wo, Wo, Wo, Wo, Wo, Wo, Wo, Wwr, Wo, Wwr, Wo, Wo, Wo, Wo, Wo, Wo, Wo, Wo, Wo, Wo, Wo, Wo, Wo, Wo, Wo, Wo, Ww, Wwr, Ww, Ww, Wwr, Wo, Wwr, Wwr, Wwr, Wwr, Wwr, Wwr, Wwr, Wwr, Wwr, Wwr, Wo, Wo, Wo, Wo, Wo, Ww
Wo, Wo, Wo, Wo, Wwr, Wo, Wo, Wo, Wo, Wo, Mm, Wo, Wo, Wo, Wwr, Wo, Wo, Wo, Wo, Wo, Wo, Wo, Wo, Wo, Wo, Wo, Ww, Wo, Ww, Wo, Ww, Wo, Wwr, Wo, Wo, Wo, Wo, Wo, Wo, Wo, Wo, Ww, Wwr, Wwr, Ww, Wwr, Wo, Wwr, Ww, Wwr, Ww, Wwr, Wo, Wo, Wo, Wo, Wo, Wo, Wo, Wo, Wo, Wo
Wo, Wo, Wwr, Wwr, Mm, Mm, Mm, Wo, Mm, Wo, Mm, Mm, Mm, Mm, Wwr, Wwr, Wo, Wo, Wo, Wo, Wo, Wo, Wo, Wo, Ww, Ww, Ww, Ww, Ww, Ww, Ww, Ww, Wwr, Wo, Wo, Wo, Wo, Wo, Wo, Wo, Wo, Wo, Wo, Wo, Ww, Wo, Ww, Ww, Ww, Ww, Wo, Wo, Wo, Wo, Wo, Wo, Wo, Wo, Wo, Wo, Ww, Ww
Wo, Wo, Wwr, Wo, Mm, Mm, Wwr, Hh, Hh, Mm, Mm, Mm, Mm, Mm, Wo, Wo, Wo, Wo, Wo, Wo, Wo, Wo, Ww, Wwr, Wwr, Wwr, Rrd, Ds, Ds, Ds, Chw, Ds, Ds, Wwr, Wwr, Wo, Wo, Wo, Wo, Wo, Wo, Wo, Wo, Wo, Wo, Ww, Wo, Ww, Wo, Wo, Wo, Wo, Wo, Wo, Wo, Wo, Wwr, Wo, Ww, Ww, Gs^Fms, Gs^Fms
Wo, Wo, Wo, Wo, Wo, Wwr, Wo, Wwr, Wo, Mm, Rr, Hhd^Vhh, Mm, Wo, Wo, Wo, Ww, Ww, Wwr, Wwr, Wwr, Ww, Ww, Wwr, Ds, Ds, Gg, Gg, Gg, Gs^Fds, Ds, Ds, Ds, Ds, Ds, Ww, Ww, Wo, Wo, Wo, Wo, Wo, Wo, Wo, Wo, Wo, Wo, Wo, Wo, Wo, Wo, Wo, Wo, Wo, Wwr, Wo, Wwr, Ww, Ss, Ww, Ss, Gs^Fms
Wo, Wo, Wwr, Wo, Wo, Wo, Wo, Wo, Wo, Mm, Ww, Wwf, Ww, Wo, Ww, Ww, Ww, Wwr, Ds, Wwr, Ds, Ww, Ds, Ds, Gg, Hd, Gg, Gg^Wm, Gg, Gg, Ds, Wwf, Wwf, Wwf, Rrd, Wwf, Ds, Wwr, Wwr, Wwr, Wo, Wo, Wo, Wo, Wo, Wo, Wo, Wo, Wo, Wo, Wo, Wo, Wo, Wo, Wwr, Wwr, Ww, Ww, Ss, Ss^Vhs, Gg, Gs^Fms
Wo, Wo, Wo, Wo, Ww, Wo, Wwr, Wo, Ww, Ww, Ww, Ww, Ww, Ww, Ww, Ww, Ds, Ds, Gg, Rd^Vh, Rd, Ds, Gg, Gg, Gs^Fds, Gs^Fds, Gs^Fds, Gg, Gg, Gg, Gg, Wwf, Ww, Ww, Ww, Rrd^Vhr, Ww, Ds, Wwr, Ww, Wo, Wo, Wo, Wo, Wo, Wwr, Wwr, Wo, Wo, Wo, Wo, Wo, Wo, Wo, Wo, Wwr, Ww, Ss, Ss, Gg, Ss, Gs^Fms
Wwf, Wwr, Wwr, Ww, Ww, Ww, Ww, Wwr, Wwr, Wwr, Ds, Ds, Ds, Ds, Ds, Ds, Gg, Gg, Gg, Gg, Ds, Rd, Gs^Fds, Gs^Fds, Gs^Fds, Gs^Fds, Gs^Fds, Ds, Gs^Fds, Gg, Gg^Vhr, Ds, Ww, Ww, Ww, Ww, Ww, Ds, Ww, Ww, Wo, Wo, Wo, Wo, Wo, Wo, Wo, Wo, Wo, Wo, Wo, Wo, Wo, Wo, Wo, Wo, Ww, Ss, Ss, Gg, Ss, Gs^Fms
Ds, Ds, Re^Vct, Ww, Ww, Ww, Ds, Ds, Ds, Ds, Gg, Gg, Gg, Md, Gg, Gg, Ds, Gg, Ds, Ds, Ds, Rd, Rd^Vh, Ds, Ds, Ds, Hd, Ds, Ds, Gg, Gg, Ww, Ww, Ww, Ww, Ww, Wwr, Ww, Wo, Wo, Wo, Wo, Ww, Ww, Wo, Ww, Wo, Ww, Ww, Wo, Wo, Wo, Wo, Ww, Ww, Ww, Dd^Do, Ss, Gg, Gg, Gs^Fms, Gs^Fms
Ss, Re, Wwf, Ww, Ww, Ds, Gg, Gs^Fds, Gs^Fds, Gg, Re^Vct, Gg, Ds, Gg, Dd^Do, Md, Ww, Ds, Ds, Ds, Ds, Rd, Rd, Ds, Ds, Ds, Ds, Hd, Hd, Hh, Gg, Ds, Ds, Ww, Ww^Bw|, Ww, Wwr, Wo, Wo, Ww, Ww, Ww, Ww, Wo, Wo, Wo, Ww, Wo, Wo, Wo, Ww, Ww, Wo, Ww, Ww, Re, Re, Gg, Ss, Ss, Gs^Fms, Gs^Fms
Ss, Re, Re, Ww, Ww, Gg, Gg, Gg, Gg, Gg, Ds, Re, Ds, Ds, Ds, Hd, Dd, Ds, Ds, Ds, Ds, Rd, Ds, Ds, Rd, Ds, Ds, Hd, Hd, Ds, Gg, Gg, Gg, Gg^Fet, Rr^Vhr, Ds, Ds, Wo, Wo, Rr, Rrd^Vhr, Rr, Wwf, Wwf, Ww, Wo, Wo, Wwf, Wo, Wo, Ww^Vm, Wo, Ss, Ss, Ds, Gg, Re, Ss^Vhs, Ss, Ss, Gg, Gs^Fms
Ss, Ss, Re, Ww, Re, Ww, Re^Vct, Gg, Gg, Ds, Ds, Re, Ds, Ds, Ds, Ds, Dd, Dd, Ds, Ds, Rd, Rd, Rd, Ds, Ds, Ds, Ww, Ww, Ds, Ds, Gg, Gg, Rd, Rd, Rd, Rr, Gg, Wo, Wwf, Chw, Rr, Rr, Wo, Wo, Ss, Wwf, Wo, Wwf, Ss, Wwf, Wo, Wo, Wo, Ss, Gg, Ss, Re, Ss, Ss, Ss, Gg, Gg
Ss, Ss, Re, Wwf, Gg, Gg, Gg, Gg, Gg, Ds, Ds, Re, Ds, Ds, Re, Ds, Ds, Ww, Ds, Rd, Rd^Vh, Hd, Ds, Rd, Ds, Ds, Dd, Ww, Ds, Ds, Ds, Gg, Rd, Gg, Gg, Rr, Wwf, Ww, Gs^Fms, Rr, Gs^Fms, Wwf, Ss, Ww, Ss, Wo, Ww, Ss, Wwf, Wwf, Ww, Wo, Ss, Ss, Ss, Gg, Re, Ss, Ss, Ss, Gs^Fms, Gs^Fms
Ss, Gg, Ww, Wwf, Gg, Gg, Gg, Re, Gg, Gg, Re, Re, Ds, Ds, Ds, Ds, Ds, Ds, Ds, Hd, Hd, Hd, Dd^Do, Rd, Ww, Ww, Ds, Ds, Ds, Ds, Gg, Hh, Rd, Gg, Gg, Wo, Rr, Rr^Vhr, Re, Wwf, Wo, Wo, Ww, Wo, Wo, Wo, Wo, Wwf, Ss, Ss, Wo, Ww, Wo, Ss, Ss, Gg, Re, Ss, Ss, Ss, Gg, Gg
Ss, Ss, Ww, Re, Re, Gg, Gg, Gg, Gg, Re, Re, Re^Vct, Dd, Ds, Ds, Ds, Ww, Ds, Hd, Ds, Md, Hd, Rd, Rd, Ds, Ds, Ds, Ww, Gg, Gs^Fmf, Rd, Rd, Rd, Gg, Wo, Wo, Gg, Re, Gs^Fms, Wwf, Ss, Wwf, Ww, Ww, Ss, Ww^Vm, Wwf, Wwf, Ww, Wo, Ss, Wwf, Ww^Vm, Wwf, Ss, Gg, Ss, Re, Ss, Ss, Gg, Gg
Ss, Ss, Ww, Gs, Re^Vct, Re, Gg, Gg, Mm^Xm, Hd, Hd, Ds, Ds, Ds, Md, Ww, Ww, Ww, Md, Md^Xm, Md^Xm, Hd, Rd, Hd, Hd, Hd, Hd, Ds, Gg, Gs^Fmf, Rd, Gs^Fmf, Wo, Wo^Bw\, Rd, Rd, Re, Re, Ss, Wo, Wo, Wwf, Wo, Wwf, Wo, Ss, Wo, Ww, Wwf, Ww, Ss, Ww, Ss, Wwf, Ss, Gg, Ss, Re, Ss, Ss, Gs^Fms, Gs^Fms
Gs, Ss, Ww, Gs, Mm^Xm, Hh, Hh, Gg, Gg, Hd, Gg, Md, Md, Md, Gg, Gg, Gg, Gg, Gg, Md, Md, Hd, Rd, Gg, Gg, Gg, Gs^Fmf, Gs^Fp, Rd, Rd, Gg, Gg, Wo, Gg, Gg, Gg, Re, Kh, Ss, Wwf, Ww^Vm, Wo, Wwf, Wwf, Wwf, Wo, Wwf, Wwf, Ss, Ww, Ww, Ww, Ww, Ww, Ss, Gg, Gg, Re, Re, Ss, Ss, Gs^Fms
Gs, Ss, Re, Ww, Mm^Xm, Mm^Xm, Gs^Fds, Gg, Gg, Gg, Gg, Gg, Hh, Md, Gg, Gg, Gg, Gg, Gg, Gg, Gg, Gg, Hh^Fdf, Gg, Gg, Rd^Vct, Rd, Rd, Gs^Fmf, Gg, Re^Vct, Wo, Gg, Gg, Hh^Fp, Gg, Hh, Ss, Ss, Hh, Ss, Wo, Ss, Ss, Re, Ww, Wo, Ss, Ww, Ww, Ww, Ss, Ww, Ss, Gg, Gg, Gs^Fms, Re, Ss, Gg, Gg, Ss
Gs, Ss, Re, Ww, Gg, Gs^Fds, Gs^Fds, Gg, Gg, Gg, Gs^Fds, Gs^Fds, Gs^Fds, Hh, Gg, Gg, Gs^Fds, Gg, Gg, Gs^Fds, Gs^Fds, Gg, Gs^Fdf, Gs^Fdf, Rd, Rd, Rd, Gs^Fmf, Gs^Fmf, Hh^Fmf, Ss, Wwf, Wwf, Hh^Fp, Hh^Fp, Hh^Fp, Gs^Fp, Hh, Ss, Ss, Hh, Ss, Ss, Ss, Ss, Wo, Ww^Vm, Wwf, Ww, Ss, Ww, Ww, Ss, Ss, Gg, Gg, Gg, Re, Ss, Ss, Gg, Gg
Gs, Gs, Ww, Ww, Re, Gg, Gg^Ve, Gs^Fds, Gs^Fds, Gg, Gg, Gg, Re, Gg, Gs^Fds, Gs^Fds, Gs^Fds, Gg, Gg, Gs^Fds, Gg, Gg, Gg, Mm, Mm, Gg, Gs^Fdf, Rd, Rd, Gg, Gs^Fmf, Ss, Ww, Gg, Rd, Re, Hh^Fp, Gs^Fp, Ss, Ss, Ss, Ss, Gg, Ss, Gs^Fp, Ss, Ss, Ss, Ss, Wwf, Ss, Ss, Ss, Ss, Gg, Ss, Gg, Re, Ss, Gs^Fms, Gg, Gg
Gs, Ss, Ww, Re, Gs, Gg, Gg, Gg, Gg, Gg, Gg, Gg^Ve, Re, Re, Re, Gg, Gg, Gg, Hh^Fp, Hh^Vhhr, Gg, Gg, Gg, Mm, Gg, Gs^Fdf, Gs^Fmf, Gs^Fdf, Gg, Rd, Rd, Ss, Wwf, Wwf, Ww, Re^Vct, Gg, Gs^Fp, Ss, Ss, Gg, Gg, Gg, Gg, Hh^Fp, Gs^Fp, Gg, Ss, Gg, Ss, Ss, Ss, Ss, Ss, Ss, Ss, Re, Re, Gs^Fms, Gs^Fms, Gg, Gg
Ss, Ss, Ww, Re, Gs, Gs, Gg, Gg, Gg, Hh, Gg, Re, Gg, Gg, Hh^Fp, Hh^Fp, Gg, Gs^Fds, Gs^Fds, Gg, Gs^Fp, Gg, Gs^Fds, Hh^Fds, Gs^Fmf, Gg, Gg, Gg, Gs^Fdf, Re^Vct, Gg, Rd, Gg, Gs^Fmf, Gs^Fp, Wo, Wo, Wo, Gg, Gg, Gs^Fp, Gg, Gg^Vhc, Gg^Fp, Gg, Gg, Gg, Gg, Wo, Gg, Ss, Gg, Gs^Vht, Ss, Re, Re, Ss, Ss, Ss, Ss, Gg, Gs^Fms
Ss, Ss, Ww, Re, Wo, Ww, Wo^Bw/, Gg, Gg, Gg, Re, Re, Re, Gg, Gg, Gg, Gs^Fds, Gg, Hh^Vhhr, Gg, Gs^Fds, Gs^Fds, Gg, Gs^Fds, Gg, Gg, Gg, Gg, Gg, Gg, Gs^Fmf, Gg, Gs^Fp, Gs^Fp, Re, Gs^Fp, Gs^Fp, Wo, Wo, Gg, Gg, Gg, Wo^Bw\, Wo, Wo, Wo, Wo, Wo, Re^Gvs, Wo, Wo, Gg, Re, Re, Ss, Gg, Gs^Fms, Gs^Fms, Gs^Fms, Gg, Gg, Gs^Fms
Gs, Ss, Ss, Wo, Re, Gg, Gg^Ve, Wo, Wo, Re, Gs^Fds, Gs^Fds, Wo, Wo, Wo, Gs^Fds, Gg, Gg, Gg, Gs^Fds, Gg, Gg, Gg, Gs^Fds, Gg, Gs^Fds, Gg, Gg, Gg, Gs^Fdf, Gg, Gs^Fp, Re, Gs^Fp, Gs^Fp, Gs^Fp, Gg^Efm, Gs^Fp, Rr, Wo^Bw/, Wo, Wo, Gg^Efm, Gg^Efm, Gg^Efm, Gg^Efm, Re^Gvs, Re^Gvs, Re^Gvs, Re^Gvs, Re^Gvs, Gg, Re, Wo, Wo, Gg, Gg, Gs^Fms, Gs^Fms, Gg, Gg, Gs^Fms
Gs, Gs, Gs, Wo, Re, Gg, Gg, Hh^Fp, Gs^Fds, Wo, Wo, Wo, Gg, Gg, Rp, Ww, Rp, Gs^Fds, Gs^Fds, Gs^Fp, Gg, Gg, Gg, Gs^Fds, Gs^Fds, Gs^Fds, Gg, Gg, Gs^Fp, Gs^Fmf, Gs^Fp, Gs^Fp, Re, Gs^Fp, Gg^Efm, Gg^Efm, Gg^Efm, Gg^Wm, Re^Gvs, Rr, Rr, Wo, Ww, Ch, Rr, Gg^Efm, Re^Gvs, Re^Gvs, Gg, Re^Gvs, Gg, Gg, Gs^Fds, Re, Wo, Ss, Ss, Gs^Fms, Gg, Gg, Gs^Fms, Gs^Fms
Gs, Gs, Ss, Wwf, Wwf, Gg, Ss, Gs^Fds, Gs^Fds, Gs, Gg, Gg, Hh, Gg, Rp, Wo^Bw/, Wo, Rp, Rp, Gg, Gs^Fp, Gs^Fp, Gs^Fp, Gs^Fp, Gg, Gg, Gg, Gs^Fp, Re, Re, Re, Re, Gs^Fp, Gs^Fp, Gg^Efm, Gg^Vhc, Re^Gvs, Re^Gvs, Re^Gvs, Re^Gvs, Rr, Ch, Chw, Rr^Vhc, Ch, Re, Re, Re^Gvs, Mm, Mm^Xm, Mm^Xm, Gg, Gg, Re, Re, Wo, Wo, Gg, Gg, Gg, Gs^Fms, Gs^Fms
Ss, Ss, Ss, Re, Wo, Ss, Gs, Gs, Gs, Gs, Gg, Gg, Gg, Gg, Gg, Rp^Vhhr, Wo, Gs^Fp, Gs^Fp, Rp, Rp, Gs^Fp, Gs^Fp, Gg, Gg, Gs^Fp, Gs^Fp, Gs^Fp, Re, Re, Gs^Fp, Gs^Fp, Gg, Gg, Re^Gvs, Re^Gvs, Re^Gvs, Re^Gvs, Re^Gvs, Re^Gvs, Rr, Rp^Vhc, Ch, Ww, Rr, Gg^Efm, Re, Hh^Fp, Gs^Fp, Gs^Fp, Gs^Fp, Gs^Fp, Gg, Gg, Gs^Fds, Re, Wo, Ss, Ss, Gg, Gs^Fms, Gs^Fms
Ss, Ss, Gs, Re, Wo, Gs, Gs, Gs, Gg, Gg, Hh^Fp, Hh^Vhhr, Gg, Gg, Gs, Gg, Gg, Wo, Gs^Fp, Gg, Gs^Fp, Rp^Dr, Rp, Rp, Rp, Gg, Re^Vht, Re, Gs^Fp, Gs^Fp, Gs^Fp, Gg, Re^Gvs, Re^Gvs, Re^Gvs, Re^Gvs, Re^Gvs, Re^Gvs, Re^Gvs, Re^Gvs, Rr, Rr, Rr, Wo, Rr, Gg^Efm, Wo, Mm^Xm, Gg, Gg, Rd, Rd, Gg, Gs^Fds, Re, Re, Wo, Ss, Ss, Gg, Gs^Fms, Gs^Fms
Gs, Gs, Gs, Re, Re, Wo, Wo, Gs, Gg, Gg, Gg, Gg, Gs, Gs, Gs, Gs, Gg, Wo, Wo, Gs^Fp, Gg, Gs^Fp, Gg, Gg, Gg, Rp, Rp, Gs^Fp, Gs^Fp, Gg, Gg, Gg, Re^Gvs, Re^Gvs, Re^Gvs, Re^Gvs, Re^Gvs, Re^Gvs, Rp, Rp, Gg^Wm, Rr, Rr, Wo^Bw/, Ww, Wo, Gg, Gs^Fp, Gs^Fp, Gs^Fp, Rd, Gs^Vht, Gg, Gg, Re, Wo, Ss, Ss, Ss, Gg, Gg, Gs^Fms
Gs, Gs, Gg, Gs, Re, Gg, Ss, Wo, Wo, Gg, Gg, Gg, Gg, Gs, Gg, Gs, Gs, Gg, Gg, Wo, Gs^Vht, Gg, Gg, Gg, Gs^Fmf, Gg, Gg, Rp, Rp, Rp, Rp, Rp, Rp, Re^Gvs, Re^Gvs, Re^Gvs, Rp, Rp, Gg^Efm, Gg^Efm, Gg^Efm, Gg^Efm, Gg^Efm, Gg^Efm, Wo, Gg, Gg, Gs^Fp, Rd, Rd, Gs^Fp, Gs^Fp, Gg, Gg, Re, Wo, Wo, Ss, Gs^Fds, Gs^Fms, Gs^Fms, Gg
Hh, Gg, Gg, Gs, Re, Ss, Hh, Gg, Gg, Wo, Wo, Hh^Fms, Wo, Gg, Gs^Fp, Rrd^Vhhr, Gs, Hh, Gg, Wo, Gs^Fp, Gg, Gg, Gs^Fmf, Gg, Gs^Fmf, Gg, Gg, Hh, Hh, Hh^Fmf, Hh, Hh, Rp, Rp, Rp, Gg, Rp^Vhc, Gg^Efm, Gg^Efm, Gg^Efm, Gg^Efm, Gg^Efm, Gg^Wm, Wo, Gg, Gg, Gs^Fp, Rd, Gs^Fp, Gs^Fp, Gs^Fp, Gg, Gg, Ss, Re, Wo, Ss, Gs^Fms, Gs^Fms, Gs^Fms, Gg
Hh, Hh, Hh, Hh, Re, Rb^Vhc, Hh, Gg, Gg, Gg^Vhc, Gg, Wo, Gg, Wo, Ww, Gg, Gg, Gg, Gg, Wo, Wo, Gg, Gs, Gg, Gg, Gg, Gg, Gs^Vht, Hh, Hh^Fms, Mm^Xm, Mm^Xm, Mm, Hh, Rp, Rp, Gg, Gg^Efm, Gg^Efm, Gg^Efm, Gg^Efm, Gg^Efm, Gg^Vhc, Wo, Gg, Gg, Gs^Fp, Rd^Vht, Gs^Fds, Gs^Fds, Gg, Gs^Fp, Gs^Fp, Ss, Gg, Re, Wo, Ss, Gs^Fms, Gs^Fms, Gg, Gs^Fms
Hh, Hh, Re, Re, Gg, Hh, Hh^Fmw, Hh^Fmw, Hh^Fmw, Hh, Gg, Gg, Gg, Gs^Fp, Gs^Fp, Wo, Wo, Gg, Gs^Fp, Gg, Gg, Wo, Gs^Vht, Gs, Gs^Fp, Gg, Gg, Gs^Fp, Gs^Fp, Mm^Xm, Hh^Fmf, Hh, Rp, Rp, Mm^Xm, Mm, Hh^Fms, Gg^Wm, Gg, Gg^Efm, Gg^Efm, Gg^Efm, Wo, Wo, Gg, Gg, Gs^Fp, Gs^Fp, Gs^Fp, Gg, Gg, Gg, Gs^Fp, Gg, Re^Vd, Re, Wo, Ss, Ss, Gs^Fms, Gs^Fms, Gs^Fms
Re, Re, Gg^Fet, Re, Re, Aa^Fma, Re, Hh^Fmw, Hh^Fmw, Hh^Fmw, Qxu, Gg, Hh, Gg, Gs, Gs, Gg, Wo, Wo, Gg, Mm, Wo, Wo, Gs, Gs, Gs^Fmf, Gg, Gs^Fmf, Gs^Fmf, Hh, Hh, Rp, Hh, Mm, Mm, Mm^Xm, Mm^Xm, Gg, Gg, Gg, Wo, Wo, Gg, Gg, Gg, Gs^Fp, Gs^Fp, Gs^Fp, Gs^Fp, Gs^Fp, Gs^Fp, Gs^Fp, Gs^Fp, Gs^Fp, Gs^Fp, Re, Re, Wo, Ss, Gs^Fms, Gs^Fms, Gs^Fms
Re, Mm, Mm, Re, Rr, Re, Aa, Re, Re, Re^Vhc, Hh, Hh, Xu, Xu, Hh, Gs, Gg, Gg, Wo, Gg, Gg, Gg, Wo, Gs^Fp, Gs, Gs^Fmf, Gs^Fmf, Gg, Gg, Gg, Rp, Rp, Gg, Hh^Fms, Gg^Vu, Hh^Fdf, Mm^Xm, Hh, Ww, Wo^Bw\, Gg, Gg, Gg, Gg, Gs^Fp, Gs^Fp, Gs^Fp, Gs^Fp, Gg, Gs^Fds, Gs^Fp, Gs^Fp, Gs^Fds, Gs^Fp, Gs^Fp, Gg, Re, Wo, Ss, Gs^Fms, Gs^Fms, Gs^Fms
Mm, Mm, Mm, Ms, Rr, Rr, Rr, Aa, Aa, Re, Aa^Fma, Hh, Xu, Hh^Fp, Ur^Vhc, Hh, Qxu, Gg, Qxu, Ww, Ww, Wo, Wo, Gs^Fp, Gs^Fp, Gs, Gs, Gs^Fmf, Rp, Rp, Gg, Gg, Ss, Gg, Gg, Gg, Wo, Wo, Gg, Gg, Gg, Gg, Gg, Gs^Fp, Gs^Fp, Gs^Fp, Gg, Kv, Gs^Fds, Gs^Fp, Gs^Fp, Gg, Gs^Vd, Gs^Fds, Gs^Fp, Gs^Fp, Re, Wo, Wo, Gs^Fms, Gs^Fdw, Gs^Fdw
Mm, Mm, Mm, Mm, Rr, Rr, Mm, Mm, Mm, Re, Re, Aa^Fma, Xu, Ur, Ur, Ur, Uh, Ur, Ur, Ur^Vhc, Ur, Ur, Wo, Hh^Fms, Gg, Hh^Fp, Gs^Fp, Gs^Fp, Rp, Gg, Ss, Ss, Ss, Ss, Ww, Wo, Gs^Fdw, Gg, Gs^Fmw, Gg, Gs^Fp, Gg, Gg, Gg, Gs^Fds, Gs^Fp, Gs^Fp, Gs^Fp, Gg, Gs^Fp, Gg, Gs^Fp, Gg, Gs^Fp, Gs^Fp, Gs^Fp, Gg, Re, Re, Wo, Wo, Gs^Fdw
Mm, Mm, Mm, Mm, Rr, Rr, Mm, Mm, Mm, Mm, Mm, Re, Aa, Re, Ur, Ur, Ur, Ur, Re, Re, Re, Ur, Hh, Wo, Hh^Fms, Hh^Fms, Hh^Fms, Gs^Fp, Rp, Gg, Rr^Vu, Hh, Wo, Wo, Gs^Fdw, Gs^Fdw, Gg, Gg, Gs^Fmw, Gs^Fp, Gs^Fp, Gg, Gs^Fp, Gs^Fp, Gg, Gg, Gs^Fp, Gs^Fp, Gg, Kv, Gg, Gs^Fds, Gs^Fp, Gg, Gg, Gg, Aa, Ms, Ms, Re, Re, Wo
Mm, Mm, Mm, Rr, Gg, Rr, Rr, Mm, Mm, Mm, Mm, Mm, Mm, Re, Uh, Ur, Re, Re, Ur, Qxu, Mm, Re, Re, Wo, Hh^Fms, Gg^Vu, Gg, Gg, Gg, Rp, Wwf, Ww, Gs^Fdw, Wo, Gs^Fdw, Gg, Gg, Gg, Gs^Fdw, Gs^Fp, Gs^Vud, Gs^Fds, Gs^Fp, Gg, Gs^Fp, Gs^Vud, Gs^Fp, Gs^Fp, Gs^Fp, Gs^Fds, Gs^Fp, Gs^Fp, Gs^Fp, Gs^Fp, Gs^Fp, Gg, Aa, Ms, Aa^Fpa, Re, Gs^Fdw, Re
Mm, Mm, Mm, Mm, Rr, Rr, Mm, Mm, Mm, Mm, Mm, Mm, Mm, Re, Ha^Fma, Re^Vhc, Uh, Uh, Uh, Rr^Vhc, Ur, Mm, Mm, Wo^Bw\, Re, Gg, Gg, Gg, Gg, Wo, Gg, Gs^Fdw, Gs^Fdw, Gs^Fdw, Gs^Fdw, Gs^Fdw, Gs^Fdw, Gg, Gg, Gs, Gs^Fp, Gs^Fp, Gs^Fp, Gs^Fp, Gs^Fp, Gs^Fp, Gs^Fp, Gs^Fp, Gs^Fp, Aa, Gg, Gs^Fp, Aa^Fpa, Gs^Fp, Aa, Re^Vd, Re, Ha^Fda, Aa^Fda, Re, Aa^Fpa, Aa^Fpa
Mm, Mm, Mm, Mm, Mm, Mm, Mm, Mm, Mm, Mm, Mm, Mm, Mm, Re, Ms, Aa, Re, Re, Re, Qxu, Mm, Mm, Mm, Wo, Hh, Re, Re, Gg, Wo^Bw\, Wo, Gg, Gg, Gg, Gg, Gg, Gs^Fdw, Gg, Gg, Gg, Gg, Gg, Gg, Aa, Aa, Aa, Gg, Aa, Gg, Aa, Aa^Fpa, Aa, Aa, Aa, Aa, Re, Re, Ms, Re, Re, Re, Mm, Mm
Mm, Mm, Mm, Mm, Mm, Mm, Mm, Mm, Mm, Mm, Mm, Mm, Mm, Re, Re, Re, Ms, Ms, Ms, Re, Re, Mm, Ww, Wo, Hh, Hh, Rb^Vu, Re, Wo, Gg, Gg, Gg, Gg^Vu, Hh^Fdw, Hh^Fdw, Gg, Gs^Fdw, Gg, Hh, Hh, Gg, Gg, Gg, Rra^Vud, Gg, Aa, Aa, Aa, Ha^Fma, Aa, Rb^Vd, Aa, Re, Re, Aa, Aa, Ha^Fpa, Ms, Mm, Mm, Mm, Mm
Mm, Mm, Mm, Mm, Mm^Xm, Mm^Xm, Mm^Xm, Mm^Xm, Mm^Xm, Mm^Xm, Mm^Xm, Mm, Mm, Mm, Mm, Mm, Mm, Ms, Mm, Aa^Fda, Re, Wwf, Re, Hh^Fmw, Hh, Hh, Mm, Wo, Mm, Hh^Fmw, Hh, Hh, Hh, Hh, Hh^Fmw, Hh, Hh, Hh, Mm, Hh, Gg, Hh, Mm, Gg, Gg, Gg, Hh, Hh, Hh, Gg, Hh^Fmf, Re, Aa, Aa, Mm, Mm, Mm, Mm, Mm, Mm, Mm, Mm
Mm^Xm, Mm^Xm, Mm^Xm, Mm^Xm, Mm^Xm, Mm^Xm, Mm^Xm, Mm^Xm, Mm^Xm, Mm^Xm, Mm^Xm, Mm^Xm, Mm^Xm, Mm, Mm, Mm, Mm, Mm, Mm, Mm, Ai, Re, Mm, Re, Re, Mm, Mm, Wwf, Re, Mm, Mm, Hh, Hh, Hh, Hh, Hh^Fmw, Hh, Hh, Mm, Rb^Vud, Mm, Mm, Mm, Mm, Mm, Hh, Mm, Hh^Fdf, Hh^Fdf, Hh, Hh, Re, Ms, Ms, Mm, Mm, Mm, Mm, Mm, Mm, Mm, Mm
Mm^Xm, Mm^Xm, Mm^Xm, Mm^Xm, Mm^Xm, Mm^Xm, Mm^Xm, Mm^Xm, Mm^Xm, Mm^Xm, Mm^Xm, Mm^Xm, Mm^Xm, Mm^Xm, Mm^Xm, Mm, Mm, Mm, Ai, Ai, Mm, Mm, Mm, Mm, Mm, Re, Re, Wwf, Mm, Re, Re, Mm, Re, Re, Re, Hh^Fmw, Re, Re, Re, Re, Re, Mm, Re, Re, Re, Re, Re, Mm, Hh, Hh, Mm, Re, Re, Mm, Mm, Mm, Mm, Mm, Mm, Mm, Mm, Mm
Mm^Xm, Mm^Xm, Mm^Xm, Mm^Xm, Mm^Xm, Mm^Xm, Mm^Xm, Mm^Xm, Mm^Xm, Mm^Xm, Mm^Xm, Mm^Xm, Mm^Xm, Mm^Xm, Mm^Xm, Mm, Mm, Mm, Mm, Mm, Mm, Mm, Mm, Mm, Mm, Mm, Mm, Wwf, Ai, Mm, Mm, Re, Rr, Gg^Efm, Rd, Rd, Rd, Rd, Rd, Gg^Efm, Gg^Efm, Re, Mm, Ms, Mm, Mm, Mm, Re, Re, Hh, Hh, Mm, Mm, Re, Ai, Mm, Mm, Mm, Mm, Mm, Mm, Mm
Mm^Xm, Mm^Xm, Mm^Xm, Mm^Xm, Mm^Xm, Mm^Xm, Mm^Xm, Mm^Xm, Mm^Xm, Mm^Xm, Mm^Xm, Mm^Xm, Mm^Xm, Mm^Xm, Mm^Xm, Mm^Xm, Mm^Xm, Mm, Mm, Mm, Mm, Mm, Mm, Mm, Mm, Mm, Mm, Mm, Mm, Mm, Mm, Rr, Rr, Gg^Efm, Gg^Efm, Re^Gvs, Re^Gvs, Gg, Re^Gvs, Gg^Efm, Mm, Mm, Mm, Mm, Mm, Mm, Mm, Mm, Mm, Re, Re, Ms, Re, Re, Mm, Mm, Mm, Mm, Mm, Mm, Mm, Mm
Mm^Xm, Mm^Xm, Mm^Xm, Mm^Xm, Mm^Xm, Mm^Xm, Mm^Xm, Mm^Xm, Mm^Xm, Mm^Xm, Mm^Xm, Mm^Xm, Mm^Xm, Mm^Xm, Mm^Xm, Mm^Xm, Mm^Xm, Mm, Mm, Mm, Mm, Mm, Mm, Mm, Mm, Mm, Mm, Mm, Mm, Mm, Mm, Rr, Rr, Gg^Efm, Gg^Efm, Gg, Gg, Re^Gvs, Mm, Mm, Mm, Mm, Mm, Mm, Mm, Mm, Mm, Mm, Mm, Mm, Mm, Re, Rr, Rr, Mm, Mm, Mm, Mm, Mm, Mm, Mm, Mm
Mm^Xm, Mm^Xm, Mm^Xm, Mm^Xm, Mm^Xm, Mm^Xm, Mm^Xm, Mm^Xm, Mm^Xm, Mm^Xm, Mm^Xm, Mm^Xm, Mm^Xm, Mm^Xm, Mm^Xm, Mm^Xm, Mm^Xm, Mm^Xm, Mm^Xm, Mm, Mm, Mm, Mm, Mm, Mm, Mm, Mm, Mm, Mm, Mm, Mm, Mm, Rr, Rr, Rr, Gg^Efm, Gg^Efm, Gg^Efm, Mm, Mm, Mm, Mm, Mm, Mm, Mm, Mm, Mm, Mm, Mm, Mm, Mm, Rr, Gg, Rr, Mm, Mm, Mm, Mm, Mm, Mm, Mm, Mm
Xv, Xv, Xv, Xv, Xv, Xv, Xv, Xv, Xv, Xv, Xv, Xv, Xv, Xv, Xv, Xv, Xv, Xv, Xv, Mm^Xm, Mm, Mm, Mm, Mm, Mm, Mm, Mm, Mm, Mm, Mm, Mm, Mm, Mm, Rr, Hhd^Vhhr, Gg^Efm, Mm, Mm, Mm, Mm, Mm, Mm, Mm, Mm, Mm, Mm, Mm, Mm, Mm, Mm, Mm, Mm, Mm, Rr, Mm, Mm, Mm, Mm, Mm, Mm, Mm, Mm
Xv, Xv, Xv, 1 Xv, Xv, 2 Xv, Xv, 3 Xv, Xv, 4 Xv, Xv, 5 Xv, Xv, 6 Xv, Xv, Xv, Xv, Xv, Xv, Mm^Xm, Mm, Mm, Mm, Mm, Mm, Mm, Mm, Mm, Mm, Mm, Mm, Mm, Mm, Mm, Mm, Mm, Mm, Mm, Mm, Mm, Mm, Mm, Mm, Mm, Mm, Mm, Mm, Mm, Mm, Mm, Mm, Mm, Mm, Mm, Mm, Mm, Mm, Mm, Mm, Mm, Mm^Xm, Mm^Xm
Xv, Xv, Xv, Xv, Xv, Xv, Xv, Xv, Xv, Xv, Xv, Xv, Xv, Xv, Xv, Xv, Xv, Xv, Xv, Mm^Xm, Mm^Xm, Mm, Mm, Mm, Mm, Mm, Mm, Mm, Mm, Mm, Mm, Mm, Mm, Mm, Mm, Mm, Mm, Mm, Mm, Mm, Mm, Mm, Mm, Mm, Mm, Mm, Mm, Mm, Mm, Mm, Mm, Mm, Mm, Mm, Mm, Mm, Mm, Mm, Mm^Xm, Mm^Xm, Mm^Xm, Mm^Xm
