Wo, Wo, Wo, Ds, Ds, Hh, Re, Hh, Md, Md, Ds, Wwf, Wwf, Wo, Wo, Wo, Wo, Wo, Wo, Wo, Wo, Wo, Wo, Wo, Wo, Wo, Wo, Wo, Wo, Wo, Wo, Wo, Wo, Wo, Wo, Wo, Wo, Wo, Wo, Wo, Wo, Wo, Wo, Wo, Wo, Wo, Wo, Wo, Wo, Wo, Wo, Wo, Wo, Wo, Wo, Wo, Wo, Ww, Ds, Gs, Gs, Gs
Wo, Wo, Wo, Wo, Wwf, Dd^Vda, Re, Dd, Dd, Ds, Ds, Wwf, Wo, Wo, Wo, Wo, Wo, Wo, Wo, Wo, Wo, Wo, Wo, Wo, Wo, Wo, Wo, Wo, Wo, Wo, Wo, Wo, Wo, Wo, Wo, Wo, Wo, Wo, Wo, Wo, Wo, Wo, Wo, Wo, Wo, Wo, Wo, Wo, Wo, Wo, Wo, Wo, Wo, Wo, Wo, Wo, Wo, Ww, Ww, Dd^Do, Ds, Gs
Wo, Wo, Wo, Wo, Wo, Wo, Wo, Dd, Ds, Ds, Wwf, Wwf, Wo, Wo, Wo, Wo, Wo, Wo, Wo, Wo, Wo, Wo, Wo, Wo, Wo, Wo, Wo, Wo, Wo, Wo, Wo, Wo, Wo, Wo, Wo, Wo, Wo, Wo, Wo, Wo, Wo, Wo, Wo, Wo, Wo, Wo, Wo, Wo, Wo, Wo, Wo, Wo, Wo, Wo, Wo, Wo, Wo, Wo, Wo, Ww, Ww, Ds
Wo, Wo, Wo, Wo, Wo, Wo, Wo, Wo, Wo, Wwf, Wo, Ww^Vm, Wo, Wo, Wo, Wo, Wo, Wo, Wo, Wo, Wo, Wo, Wo, Wo, Wo, Wo, Wo, Wo, Wo, Wo, Wo, Wo, Wo, Wo, Wo, Wo, Wo, Wo, Wo, Wo, Wo, Wo, Wo, Wo, Wo, Wo, Wo, Wo, Wo, Wo, Wo, Wo, Wo, Wo, Wo, Wo, Wo, Wo, Wo, Wo, Wo, Ww
Wo, Wo, Wo, Wo, Wo, Wo, Wo, Wo, Wo, Wo, Wo, Wo, Wo, Wo, Wo, Wo, Wo, Wo, Wo, Wo, Wo, Wo, Wo, Wo, Wo, Wo, Ww, Wo, Ww, Wo, Ww, Wo, Wo, Wo, Wo, Wo, Wo, Wo, Wo, Wo, Wo, Wo, Wo, Wo, Wo, Wo, Wo, Wo, Wo, Wo, Wo, Wo, Wo, Wo, Wo, Wo, Wo, Wo, Wo, Wo, Wo, Wo
Wo, Wo, Wo, Wo, Wo, Wo, Wo, Wo, Wo, Wo, Wo, Wo, Wo, Wo, Wo, Wo, Wo, Wo, Wo, Wo, Wo, Wo, Wo, Wo, Ww, Ww, Ww, Ww, Ww, Ww, Ww, Ww, Ww, Wo, Wo, Wo, Wo, Wo, Wo, Wo, Wo, Wo, Wo, Wo, Wo, Wo, Wo, Wo, Wo, Wo, Wo, Wo, Wo, Wo, Wo, Wo, Wo, Wo, Wo, Wo, Ww, Ww
Wo, Wo, Wo, Wo, Wo, Wo, Wo, Wo, Wo, Wo, Wo, Wo, Wo, Wo, Wo, Wo, Wo, Wo, Wo, Wo, Wo, Wo, Ww, Ww, Ww, Ww, Ds, Ds, Ds, Ds, Chw, Ds, Ds, Ww, Ww, Wo, Wo, Wo, Wo, Wo, Wo, Wo, Wo, Wo, Wo, Wo, Wo, Wo, Wo, Wo, Wo, Wo, Wo, Wo, Wo, Wo, Wo, Wo, Ww, Ww, Gs^Fms, Gs^Fms
Wo, Wo, Wo, Wo, Wo, Wo, Wo, Wo, Wo, Wo, Wo, Ww^Vm, Wwf, Wo, Wo, Wo, Ww, Ww, Ww, Ww, Ww, Ww, Ww, Ww, Ds, Ds, Gg, Gg, Gg, Gs^Fds, Ds, Ds, Ds, Ds, Ds, Ww, Ww, Wo, Wo, Wo, Wo, Wo, Wo, Wo, Wo, Wo, Wo, Wo, Wo, Wo, Wo, Wo, Wo, Wo, Wo, Wo, Wo, Ww, Ss, Ww, Ss, Gs^Fms
Wo, Wo, Wo, Wo, Wo, Wo, Wo, Wo, Wo, Wo, Ww, Wwf, Ww, Wo, Ww, Ww, Ww, Ww, Ds, Ww, Ds, Ww, Ds, Ds, Gg, Hd, Gg, Gg^Wm, Gg, Gg, Ds, Wwf, Wwf, Wwf, Gg, Wwf, Ds, Ww, Ww, Wo, Wo, Wo, Wo, Wo, Wo, Wo, Wo, Wo, Wo, Wo, Wo, Wo, Wo, Wo, Wo, Wo, Ww, Ww, Ss, Ss^Vhs, Gg, Gs^Fms
Wo, Wo, Wo, Wo, Ww, Wo, Ww, Wo, Ww, Ww, Ww, Ww, Ww, Ww, Ww, Ww, Ds, Ds, Gg, Gg^Vh, Rd, Ds, Gg, Gg, Gs^Fds, Gs^Fds, Gs^Fds, Gg, Gg, Gg, Gg, Wwf, Ww, Ww, Ww, Gg^Vh, Ww, Ds, Ww, Ww, Wo, Wo, Wo, Wo, Wo, Wo, Wo, Wo, Wo, Wo, Wo, Wo, Wo, Wo, Wo, Wo, Ww, Ss, Ss, Gg, Ss, Gs^Fms
Wwf, Wwf, Wwf, Ww, Ww, Ww, Ww, Ww, Ww, Ww, Ds, Ds, Ds, Ds, Ds, Ds, Gg, Gg, Gg, Gg, Ds, Rd, Gs^Fds, Gs^Fds, Gs^Fds, Gs^Fds, Gs^Fds, Ds, Gs^Fds, Gg, Gg^Vh, Ds, Ww, Ww, Ww, Ww, Ww, Ds, Ww, Ww, Wo, Wo, Wo, Wo, Wo, Wo, Wo, Wo, Wo, Wo, Wo, Wo, Wo, Wo, Wo, Wo, Ww, Ss, Ss, Gg, Ss, Gs^Fms
Ds, Ds, Dd^Vda, Ww, Ww, Ww, Ds, Ds, Ds, Ds, Gg, Gg, Gg, Md, Gg, Gg, Ds, Gg, Ds, Ds, Ds, Rd, Gg^Vh, Ds, Ds, Ds, Hd, Ds, Ds, Gg, Gg, Ww, Ww, Ww, Ww, Ww, Ww, Ww, Wo, Wo, Ww, Wo, Ww, Ww, Ww, Ww, Ww, Ww, Ww, Wo, Ww, Wo, Ww, Ww, Ww, Ww, Dd^Do, Ss, Gg, Gg, Gs^Fms, Gs^Fms
Ss, Re, Wwf, Ww, Ww, Ds, Gg, Gs^Fds, Gs^Fds, Gg, Gg^Vh, Gg, Ds, Gg, Dd^Do, Md, Ww, Ds, Ds, Ds, Ds, Rd, Rd, Ds, Ds, Ds, Ds, Hd, Hd, Hh, Gg, Ds, Ds, Ww, Ww^Bw|, Ww, Wo, Wo, Wo, Ww, Ww, Ww, Ww, Ww, Ww, Ww, Ds, Ww, Ww, Ww, Ww, Ww, Ww, Ww, Ww, Re, Re, Gg, Ss, Ss, Gs^Fms, Gs^Fms
Ss, Re, Re, Ww, Ww, Gg, Gg, Gg, Gg, Gg, Ds, Re, Ds, Ds, Ds, Hd, Dd, Ds, Ds, Ds, Ds, Rd, Ds, Ds, Rd, Ds, Ds, Hd, Hd, Ds, Gg, Gg, Gg, Gg^Fet, Gg^Vh, Ds, Ds, Wo, Gg, Ss, Ww^Vm, Ss, Ds, Ds, Gs^Fms, Ds, Gg, Ds, Gg, Ds, Ww^Vm, Ds, Ds, Ds, Ds, Gg, Re, Ss^Vhs, Ss, Ss, Gg, Gs^Fms
Ss, Ss, Re, Ww, Re, Ww, Rp^Vhc, Gg, Gg, Ds, Ds, Re, Ds, Ds, Ds, Ds, Dd, Dd, Ds, Ds, Rd, Rd, Rd, Ds, Ds, Ds, Ww, Ww, Ds, Ds, Gg, Gg, Rd, Rd, Rd, Rr, Gg, Wo, Gg, Chw, Ss, Wwf, Ss, Ss, Ss, Gg, Ww, Gg, Ss, Gg, Gg, Ss, Ss, Gg, Gg, Ss, Re, Ss, Ss, Ss, Gg, Gg
Ss, Ss, Re, Wwf, Gg, Gg, Gg, Gg, Gg, Ds, Ds, Re, Ds, Ds, Re, Ds, Ds, Ww, Ds, Gg, Gg^Vh, Hd, Ds, Rd, Ds, Ds, Dd, Ww, Ds, Ds, Ds, Gg, Rd, Gg, Gg, Rr, Wwf, Ww, Gs^Fms, Gg, Gs^Fms, Ss, Ss, Ww, Ss, Ww, Ww, Ss, Gg, Re, Ww, Ss, Ss, Ss, Gg, Gg, Re, Ss, Ss, Ss, Gs^Fms, Gs^Fms
Ss, Ss, Ww, Wwf, Gg, Gg, Gg, Re, Gg, Gg, Gg, Re, Re, Ds, Ds, Ds, Ds, Ds, Ds, Hd, Hd, Rd, Dd^Do, Rd, Ww, Ww, Ds, Ds, Ds, Ds, Gg, Hh, Rd, Gg, Gg, Wo, Rr, Rp^Vhc, Re, Gg, Gg, Ss, Wwf, Ss, Wwf, Ss, Wwf, Gg, Ss, Ss, Ww, Ww, Ss, Re, Gg, Gg, Re, Ss, Ss, Ss, Gg, Gg
Ss, Ss, Ww, Re, Re, Gg, Gg, Gg, Gg, Re, Re, Gg^Vh, Re, Gs^Fds, Ds, Ds, Ww, Ds, Hd, Ds, Md, Ds, Rd, Rd, Ds, Ds, Ww, Ww, Gg, Gs^Fmf, Rd, Rd, Rd, Gg, Wo, Wo, Gg, Re, Gs^Fms, Re, Ss, Ss, Ss, Wwf, Ss, Gg^Vh, Gg, Ss, Ww, Ss, Ss, Gg, Ww^Vm, Ss, Gg, Gg, Ss, Re, Ss, Ss, Gg, Gg
Ss, Ss, Ww, Gs, Gg^Vh, Re, Gg, Gg, Mm^Xm, Hd, Hd, Re, Ds, Ds, Md, Ww, Ww, Ww, Md, Md^Xm, Md^Xm, Hd, Rd, Hd, Hd, Hd, Gs^Fdf, Ds, Gg, Gs^Fmf, Rd, Gs^Fmf, Wo, Wo^Bw\, Rd, Rd, Re, Re, Ss, Ss, Ss, Ss, Ss, Wwf, Ss, Ss, Gg, Gs^Fms, Ww, Ww, Ss, Gg, Ss, Ss, Ss, Gg, Ss, Re, Ss, Ss, Gs^Fms, Gs^Fms
Gs, Ss, Ww, Gs, Mm^Xm, Hh, Hh, Gg, Gg, Hd, Gg, Md, Md, Md, Gg, Gg, Gg, Gg, Gg, Md, Md, Hd, Rd, Gg, Gg, Gg, Gs^Fdf, Gs^Fdf, Rd, Rd, Gg, Gg, Wo, Gg, Gg, Gg, Re, Kh, Ss, Hh, Gg^Vh, Gg, Gg, Gg, Ss, Ss, Gs^Fms, Gs^Fms, Gg, Ww, Re, Re, Ss, Gg, Ss, Gg, Gg, Re, Re, Ss, Ss, Gs^Fms
Gs, Ss, Re, Ww, Mm^Xm, Mm^Xm, Gs^Fds, Gg, Gg, Gg, Gg, Gg, Hh, Md, Gg, Gg, Gg, Gg, Gg, Gg, Gg, Gg, Hd, Gg, Gg, Gg^Vh, Rd, Rd, Gg, Gg, Gg^Vh, Wo, Gg, Gg, Hh^Fp, Gg, Hh, Ss, Ss, Hh, Ss, Gg, Ss, Re, Re, Ww, Ww, Gg, Ww, Gg, Ww, Ss, Ww, Ss, Gg, Gg, Gs^Fms, Re, Ss, Gg, Gg, Ss
Gs, Ss, Re, Ww, Gg, Gs^Fds, Gs^Fds, Gg, Gg, Gg, Gs^Fds, Gs^Fds, Gs^Fds, Hh, Gg, Gg, Gs^Fds, Gg, Gg, Gs^Fds, Gs^Fds, Gg, Gg, Hd, Rd, Rd, Rd, Gs^Fdf, Gg, Hh, Ss, Wwf, Wwf, Hh^Fp, Hh^Fp, Hh^Fp, Gd^Fdf, Hh, Ss, Ss, Hh, Ss, Ss, Ss, Ss, Re, Ww^Vm, Gg, Ss, Ss, Ww, Ww, Ss, Ss, Gg, Gg, Gg, Re, Ss, Ss, Gg, Gg
Gs, Gs, Ww, Ww, Re, Gg, Gg^Vh, Gs^Fds, Gs^Fds, Gg, Gg, Gg, Re, Gg, Gs^Fds, Gs^Fds, Gs^Fds, Gg, Gg, Gs^Fds, Gg, Gg, Gg, Mm, Mm, Gg, Gg, Rd, Rd, Gg, Gs^Fmf, Ss, Ww, Gg, Rd, Re, Hh^Fp, Gs^Fp, Ss, Ss, Ss, Ss, Gg, Ss, Gs^Fp, Ss, Ss, Ss, Ss, Gg, Ss, Ss, Ss, Ss, Gg, Ss, Gg, Re, Ss, Gs^Fms, Gg, Gg
Gs, Ss, Ww, Re, Gs, Gg, Gg, Gg, Gg, Gg, Gg, Gg^Vh, Re, Re, Re, Gg, Gg, Gg, Hh^Fp, Gg^Vh, Gg, Gg, Gg, Ww, Gg, Gs^Fdf, Gg, Gg, Gg, Rd, Rd, Ss, Wwf, Wwf, Ww, Gg^Vh, Gg, Gs^Fp, Ss, Ss, Gg, Gg, Gg, Gg, Hh^Fp, Gs^Fp, Gg, Ss, Gg, Ss, Ss, Ss, Ss, Ss, Ss, Ss, Re, Re, Gs^Fms, Gs^Fms, Gg, Gg
Ss, Ss, Ww, Re, Gs, Gs, Gg, Gg, Gg, Hh, Gg, Re, Gg, Gg, Hh^Fp, Hh^Fp, Gg, Gs^Fds, Gs^Fds, Gg, Ww, Gs^Dr, Ww, Hh, Gg, Gg, Gg, Gg, Hh, Gg^Vh, Gg, Rd, Gg, Gs^Fmf, Gs^Fp, Wo, Wo, Wo, Gg, Gg, Gs^Fp, Gg, Gg^Vh, Gs^Fp, Gg, Gg, Gg, Gg, Wo, Gg, Ss, Gg, Gg^Vh, Gg, Re, Re, Ss, Ss, Ss, Ss, Gg, Gs^Fms
Ss, Ss, Ww, Re, Wo, Ww, Wo^Bw/, Gg, Gg, Gg, Re, Re, Re, Gg, Gg, Gg, Gs^Fds, Gs^Dr, Gg^Ve, Gg, Gg, Gs^Fds, Gg, Ds, Gg, Gg, Mm, Gg, Gg, Gg, Gs^Fmf, Gg, Gs^Fp, Gs^Fp, Re, Gs^Fp, Gs^Fp, Wo, Wo, Gg, Gg, Gg, Wo^Bw\, Wo, Wo, Wo, Wo, Wo, Re^Gvs, Wo, Wo, Gg, Re, Re, Ss, Gg, Gs^Fms, Gs^Fms, Gs^Fms, Gg, Gg, Gs^Fms
Gs, Ss, Ss, Wo, Re, Gg, Gg^Vh, Wo, Wo, Re, Gs^Fds, Gs^Fds, Wo, Wo, Wo, Gs^Fds, Gg, Gg, Gg, Gg, Gg, Gg, Mm, Mm, Gg, Gg, Gg, Gg, Gg, Gs^Fdf, Gg, Gs^Fp, Re, Gs^Fp, Gs^Fp, Gs^Fp, Gg, Gs^Fp, Rr, Wo^Bw/, Wo, Wo, Gg, Gg, Gg, Gg, Re^Gvs, Re^Gvs, Re^Gvs, Re^Gvs, Re^Gvs, Gg, Re, Wo, Wo, Gg, Gg, Gs^Fms, Gs^Fms, Gg, Gg, Gs^Fms
Gs, Gs, Gs, Wo, Re, Gg, Gg, Hh^Fp, Gs^Fds, Wo, Wo, Wo, Gg, Gg, Rp, Ww, Rp, Gs^Fds, Gs^Fds, Gs^Fp, Gg, Gg, Mm, Mm, Gg, Gg, Gg, Gg, Gs^Fp, Gs^Fmf, Gs^Fp, Gs^Fp, Re, Gs^Fp, Gg, Gg, Gg, Gg^Wm, Re^Gvs, Rr, Rr, Wo, Ww, Ch, Rr, Gg, Re^Gvs, Re^Gvs, Re^Gvs, Re^Gvs, Gg, Gg, Gs^Fds, Re, Wo, Ss, Ss, Gs^Fms, Gg, Gg, Gs^Fms, Gs^Fms
Gs, Gs, Ss, Wwf, Wwf, Gg, Ss, Gs^Fds, Gs^Fds, Gs, Gg, Gg, Hh, Gg, Rp, Wo^Bw/, Wo, Rp, Rp, Gg, Gg, Gg, Hh, Gg, Gg, Gg, Gg, Gs^Fp, Re, Re, Re, Re, Gs^Fp, Gs^Fp, Gg, Gg^Vh, Re^Gvs, Re^Gvs, Re^Gvs, Re^Gvs, Rr, Ch, Chw, Rp^Vhc, Ch, Re, Re, Re^Gvs, Mm, Mm^Xm, Mm^Xm, Gg, Gg, Re, Re, Wo, Wo, Gg, Gg, Gg, Gs^Fms, Gs^Fms
Ss, Ss, Ss, Re, Wo, Ss, Gs, Gs, Gs, Gs, Gg, Gg, Gg, Gg, Gg, Rp^Vhc, Wo, Gs^Fp, Gs^Fp, Rp, Rp, Wo, Wo, Gg, Gg, Gg, Gg, Gs^Fp, Re, Re, Gs^Fp, Gs^Fp, Gg, Gg, Re^Gvs, Re^Gvs, Re^Gvs, Re^Gvs, Re^Gvs, Re^Gvs, Rr, Rp^Vhc, Ch, Ww, Rr, Gg, Re, Hh^Fp, Gs^Fp, Gs^Fp, Gs^Fp, Gs^Fp, Gg, Gg, Gs^Fds, Re, Wo, Ss, Ss, Gg, Gs^Fms, Gs^Fms
Ss, Ss, Gs, Re, Wo, Gs, Gs, Gs, Gg, Gg, Hh^Fp, Gg^Vh, Gg, Gg, Gs, Gg, Gg, Wo, Gs^Fp, Gg, Hh, Rp^Dr, Rp, Rp, Rp, Gg, Rp^Vhc, Re, Gs^Fp, Gs^Fp, Gs^Fp, Gg, Re^Gvs, Re^Gvs, Re^Gvs, Re^Gvs, Re^Gvs, Re^Gvs, Re^Gvs, Re^Gvs, Rr, Rr, Rr, Wo, Rr, Gg, Wo, Mm^Xm, Gg, Gg, Rd, Rd, Gg, Gs^Fds, Re, Re, Wo, Ss, Ss, Gg, Gs^Fms, Gs^Fms
Gs, Gs, Gs, Re, Re, Wo, Wo, Gs, Gg, Gg, Gg, Gg, Gs, Gs, Gs, Gs, Gg, Wo, Wo, Hh, Gg, Hh, Gg, Gg, Gg, Rp, Rp, Gg, Gs^Fp, Gg, Gg, Gg, Re^Gvs, Re^Gvs, Re^Gvs, Re^Gvs, Re^Gvs, Re^Gvs, Rp, Rp, Gg^Wm, Rr, Rr, Wo^Bw/, Ww, Wo, Gg, Gs^Fp, Gs^Fp, Gs^Fp, Rd, Gg^Vh, Gg, Gg, Re, Wo, Ss, Ss, Ss, Gg, Gg, Gs^Fms
Gs, Gs, Gg, Gs, Re, Gg, Ss, Wo, Wo, Gg, Gg, Gg, Gg, Gs, Gg, Gs, Gs, Gg, Gg, Wo, Gg^Vh, Gg, Gg, Gg, Gs^Fmf, Gg, Gg, Rp, Rp, Rp, Rp, Rp, Rp, Re^Gvs, Re^Gvs, Re^Gvs, Rp, Rp, Gg, Gg, Gg, Gg, Gg, Gg, Wo, Gg, Gg, Gs^Fp, Rd, Rd, Gs^Fp, Gs^Fp, Gg, Gg, Re, Wo, Wo, Ss, Gs^Fds, Gs^Fms, Gs^Fms, Gg
Hh, Gg, Gg, Gs, Re, Ss, Hh, Gg, Gg, Wo, Wo, Hh^Fms, Wo, Gg, Gs^Fp, Gg^Vh, Gs, Hh, Gg, Wo, Gs^Fp, Gg, Gg, Gs^Fmf, Gg, Gs^Fmf, Gg, Gg, Hh, Hh, Hh^Fmf, Hh, Hh, Rp, Rp, Rp, Gg, Gg^Vh, Gg, Gg, Gg, Gg, Gg, Gg^Wm, Wo, Gg, Gg, Gs^Fp, Rd, Gs^Fp, Gs^Fp, Gs^Fp, Gg, Gg, Ss, Re, Wo, Ss, Gs^Fms, Gs^Fms, Gs^Fms, Gg
Hh, Hh, Hh, Hh, Re, Uu^Vu, Hh, Gg, Gg, Rp^Vhc, Gg, Wo, Gg, Wo, Ww, Gg, Gg, Gg, Gg, Wo, Wo, Gg, Gs, Gg, Gg, Gg, Gg, Gg^Vh, Hh, Hh^Fms, Mm^Xm, Mm^Xm, Mm, Hh, Rp, Rp, Gg, Gg, Gg, Gg, Gg, Gg, Gg^Vh, Wo, Gg, Gg, Gs^Fp, Gg^Vh, Gs^Fds, Gs^Fds, Gg, Gs^Fp, Gs^Fp, Ss, Gg, Re, Wo, Ss, Gs^Fms, Gs^Fms, Gg, Gs^Fms
Hh, Hh, Re, Re, Gg, Hh, Hh^Fmw, Hh^Fmw, Hh^Fmw, Hh, Gg, Gg, Gg, Gs^Fp, Gs^Fp, Wo, Wo, Gg, Gs^Fp, Gg, Gg, Wo, Gg^Vh, Gs, Gs^Fp, Gg, Gg, Gs^Fp, Gs^Fp, Mm^Xm, Hh^Fmf, Hh, Rp, Rp, Mm^Xm, Mm, Hh^Fms, Gg^Wm, Gg, Gg, Gg, Gg, Wo, Wo, Gg, Gg, Gs^Fp, Gs^Fp, Gs^Fp, Gg, Gg, Gg, Gs^Fp, Gg, Gg^Vh, Re, Wo, Ss, Ss, Gs^Fms, Gs^Fms, Gs^Fms
Re, Re, Gg^Fet, Re, Re, Aa^Fma, Re, Hh^Fmw, Hh^Fmw, Hh^Fmw, Qxu, Gg, Hh, Gg, Gs, Gs, Gg, Wo, Wo, Gg, Mm, Wo, Wo, Gs, Gs, Gs^Fmf, Gg, Gs^Fmf, Gs^Fmf, Hh, Hh, Rp, Hh, Mm, Mm, Mm^Xm, Mm^Xm, Gg, Gg, Gg, Wo, Wo, Gg, Gg, Gg, Gs^Fp, Gs^Fp, Gs^Fp, Gs^Fp, Gs^Fp, Gs^Fp, Gs^Fp, Gs^Fp, Gs^Fp, Gs^Fp, Re, Re, Wo, Ss, Gs^Fms, Gs^Fms, Gs^Fms
Re, Mm, Mm, Re, Aa^Fma, Re, Aa, Re, Re, Uu^Vu, Hh, Hh, Xu, Xu, Hh, Gs, Gg, Gg, Wo, Gg, Gg, Gg, Wo, Gs^Fp, Gs, Gs^Fmf, Gs^Fmf, Gg, Gg, Gg, Rp, Rp, Gg, Hh^Fms, Gg^Vh, Hh^Fdf, Mm^Xm, Hh, Ww, Wo^Bw\, Gg, Gg, Gg, Gg, Gs^Fp, Gs^Fp, Gs^Fp, Gs^Fp, Gg, Gs^Fds, Gs^Fp, Gs^Fp, Gs^Fds, Gs^Fp, Gs^Fp, Gg, Re, Wo, Ss, Gs^Fms, Gs^Fms, Gs^Fms
Mm, Mm, Mm, Ms, Mm, Mm, Mm, Aa, Aa, Re, Aa^Fma, Hh, Xu, Hh^Fp, Uu^Vu, Hh, Qxu, Gg, Hh, Ww, Ww, Wo, Wo, Gs^Fp, Gs^Fp, Gs, Gs, Gs^Fmf, Rp, Rp, Gg, Gg, Ss, Gg, Gg, Gg, Wo, Wo, Gg, Gg, Gg, Gg, Gg, Gs^Fp, Gs^Fp, Gs^Fp, Gg, Kv, Gs^Fds, Gs^Fp, Gs^Fp, Gg, Gg^Ve, Gs^Fds, Gs^Fp, Gs^Fp, Re, Wo, Wo, Gs^Fms, Gs^Fdw, Gs^Fdw
Mm, Mm, Mm, Mm, Mm, Mm, Mm, Mm, Mm, Re, Re, Aa^Fma, Xu, Ur, Ur, Ur, Uh, Ur, Ur, Rp^Vhc, Ur, Ur, Wo, Hh^Fms, Gg, Hh^Fp, Gs^Fp, Gs^Fp, Rp, Gg, Ss, Ss, Ss, Ss, Ww, Wo, Gs^Fdw, Gg, Gs^Fmw, Gg, Gs^Fp, Gg, Gg, Gg, Gs^Fds, Gs^Fp, Gs^Fp, Gs^Fp, Gg, Gs^Fp, Gg, Gs^Fp, Gg, Gs^Fp, Gs^Fp, Gs^Fp, Gg, Re, Re, Wo, Wo, Gs^Fdw
Mm, Mm, Mm, Mm, Mm, Mm, Mm, Mm, Mm, Mm, Mm, Re, Aa, Re, Ur, Ur, Ur, Ur, Re, Re, Re, Ur, Hh, Wo, Hh^Fms, Hh^Fms, Hh^Fms, Gs^Fp, Rp, Gg, Rp^Vhc, Hh, Wo, Wo, Gs^Fdw, Gs^Fdw, Gg, Gg, Gs^Fmw, Gs^Fp, Gs^Fp, Gg, Gs^Fp, Gs^Fp, Gg, Gg, Gs^Fp, Gs^Fp, Gg, Kv, Gg, Gs^Fds, Gs^Fp, Gg, Gg, Gg, Aa, Ms, Ms, Re, Re, Wo
Mm, Mm, Mm, Mm, Mm, Mm, Mm, Mm, Mm, Mm, Mm, Mm, Mm, Re, Ur, Ur, Re, Re, Ur, Qxu, Qxu, Re, Re, Wo, Hh^Fms, Gg^Vh, Gg, Gg, Gg, Rp, Wwf, Ww, Gs^Fdw, Wo, Gs^Fdw, Gg, Gg, Gg, Gs^Fdw, Gs^Fp, Gg^Vh, Gs^Fds, Gs^Fp, Gg, Gs^Fp, Gg^Ve, Gs^Fp, Gs^Fp, Gs^Fp, Gs^Fds, Gs^Fp, Gs^Fp, Gs^Fp, Gs^Fp, Gs^Fp, Gg, Aa, Ms, Aa^Fpa, Re, Gs^Fdw, Re
Mm, Mm, Mm, Mm, Mm, Mm, Mm, Mm, Mm, Mm, Mm, Mm, Mm, Re, Aa, Uu^Vu, Re, Uh, Ur, Uu^Vu, Ur, Mm, Mm, Wo^Bw\, Re, Gg, Gg, Gg, Gg, Wo, Gg, Gs^Fdw, Gs^Fdw, Gs^Fdw, Gs^Fdw, Gs^Fdw, Gs^Fdw, Gg, Gg, Gg, Gs^Fp, Gg, Gs^Fp, Gs^Fp, Gs^Fp, Gs^Fp, Gs^Fp, Gs^Fp, Gs^Fp, Aa, Gg, Gs^Fp, Aa^Fpa, Gs^Fp, Aa, Gg^Vh, Re, Ha^Fda, Aa^Fda, Re, Aa^Fpa, Aa^Fpa
Mm, Mm, Mm, Mm, Mm, Mm, Mm, Mm, Mm, Mm, Mm, Mm, Mm, Re, Ms, Aa, Re, Re, Re, Qxu, Mm, Mm, Mm, Wo, Hh, Re, Re, Gg, Wo^Bw\, Wo, Gg, Gg, Gg, Gg, Gg, Gs^Fdw, Gg, Gg, Gg, Gg, Gg, Gg, Aa, Aa, Aa, Gg, Aa, Gg, Aa, Aa^Fpa, Aa, Aa, Aa, Aa, Re, Re, Ms, Re, Re, Re, Mm, Mm
Mm, Mm, Mm, Mm, Mm, Mm, Mm, Mm, Mm, Mm, Mm, Mm, Mm, Re, Re, Re, Ms, Ms, Ms, Re, Re, Mm, Ww, Wo, Hh, Hh, Uu^Vu, Re, Wo, Gg, Gg, Gg, Gg^Vh, Hh^Fdw, Hh^Fdw, Gg, Gs^Fdw, Gg, Hh, Gg, Gg, Gg, Gg, Gg^Vh, Gg, Aa, Aa, Aa, Ha^Fma, Aa, Hh^Vhh, Aa, Re, Re, Aa, Aa, Ha^Fpa, Ms, Mm, Mm, Mm, Mm
Mm, Mm, Mm, Mm, Mm^Xm, Mm^Xm, Mm^Xm, Mm^Xm, Mm^Xm, Mm^Xm, Mm^Xm, Mm, Mm, Mm, Mm, Mm, Mm^Xm, Ms, Mm, Aa^Fda, Re, Wwf, Re, Hh^Fmw, Hh, Hh, Mm, Wo, Mm, Hh^Fmw, Hh, Hh, Hh, Hh, Hh^Fmw, Hh, Hh, Hh, Mm, Gs^Fmf, Gg, Hh, Mm, Gg, Gg, Gg, Hh, Hh, Hh, Gg, Hh^Fmf, Re, Aa, Aa, Mm, Mm, Mm, Mm, Mm, Mm, Mm, Mm
Mm^Xm, Mm^Xm, Mm^Xm, Mm^Xm, Mm^Xm, Mm^Xm, Mm^Xm, Mm^Xm, Mm^Xm, Mm^Xm, Mm^Xm, Mm^Xm, Mm^Xm, Mm^Xm, Mm^Xm, Mm^Xm, Mm, Mm^Xm, Mm^Xm, Mm, Ai, Re, Mm, Re, Re, Mm, Mm, Wwf, Re, Mm, Mm, Hh, Hh, Hh, Hh, Hh^Fmw, Hh, Hh, Mm, Gg^Ve, Mm, Mm, Mm, Mm, Mm, Hh, Mm, Hh^Fdf, Hh^Fdf, Hh, Hh, Re, Ms, Ms, Mm, Mm, Mm, Mm, Mm, Mm, Mm, Mm
Xv, Xv, Xv, Xv, Xv, Xv, Xv, Xv, Xv, Xv, Xv, Xv, Xv, Xv, Xv, Xv, Xv, Xv, Mm^Xm, Ai, Mm^Xm, Mm, Mm^Xm, Mm, Mm, Re, Re, Wwf, Mm, Re, Re, Mm, Re, Re, Re, Hh^Fmw, Re, Re, Re, Re, Re, Mm, Re, Re, Re, Re, Re, Mm, Hh, Hh, Mm, Re, Re, Mm, Mm, Mm, Mm, Mm, Mm, Mm, Mm^Xm, Mm
Xv, Xv, Xv, Xv, Xv, Xv, Xv, Xv, Xv, Xv, Xv, Xv, Xv, Xv, Xv, Xv, Xv, Xv, Mm^Xm, Mm^Xm, Mm, Mm^Xm, Mm^Xm, Mm^Xm, Mm^Xm, Mm, Mm, Wwf, Ai, Mm, Mm, Re, Mm, Mm, Mm, Re, Mm, Mm, Mm, Mm, Mm, Re, Mm, Ms, Mm, Mm, Mm, Re, Re, Hh, Hh, Mm, Mm, Re, Ai, Mm, Mm, Mm, Mm^Xm, Mm^Xm, Mm, Mm
Xv, Xv, Xv, Xv, Xv, Xv, Xv, Xv, Xv, Xv, Xv, Xv, Xv, Xv, Xv, Xv, Xv, Xv, Mm, Mm, Mm, Mm, Mm, Mm, Mm, Mm^Xm, Mm^Xm, Mm^Xm, Mm^Xm, Mm^Xm, Mm^Xm, Mm, Mm^Xm, Mm^Xm, Mm^Xm, Mm, Mm, Mm, Mm^Xm, Mm^Xm, Mm^Xm, Mm, Mm^Xm, Mm, Mm^Xm, Mm, Mm, Mm, Mm, Re, Re, Ms, Re, Re, Mm, Mm, Mm^Xm, Mm^Xm, Mm, Mm, Mm, Mm
Xv, Xv, Xv, Xv, Xv, Xv, Xv, Xv, Xv, Xv, Xv, Xv, Xv, Xv, Xv, Xv, Xv, Xv, Mm, Mm, Mm, Mm, Mm, Mm, Mm, Mm, Mm, Mm, Mm, Mm, Mm, Mm^Xm, Mm, Mm, Mm, Mm^Xm, Mm^Xm, Mm^Xm, Mm, Mm, Mm, Mm^Xm, Mm, Mm^Xm, Mm, Mm^Xm, Mm^Xm, Mm^Xm, Mm^Xm, Mm, Mm, Re, Mm, Mm, Mm^Xm, Mm^Xm, Mm, Mm, Mm, Mm, Mm, Mm
Xv, Xv, Xv, Xv, Xv, Xv, Xv, Xv, Xv, Xv, Xv, Xv, Xv, Xv, Xv, Xv, Xv, Xv, Mm^Xm, Mm, Mm, Mm, Mm, Mm, Mm, Mm, Mm, Mm, Mm, Mm, Mm, Mm, Mm, Mm, Mm, Mm, Mm, Mm, Mm, Mm, Mm, Mm, Mm, Mm, Mm, Mm, Mm, Mm, Mm, Mm^Xm, Mm^Xm, Mm, Mm^Xm, Mm^Xm, Mm, Mm, Mm, Mm, Mm, Mm, Mm, Mm
Xv, Xv, Xv, Xv, Xv, Xv, Xv, Xv, Xv, Xv, Xv, Xv, Xv, Xv, Xv, Xv, Xv, Xv, Mm^Xm, Mm^Xm, Mm, Mm, Mm, Mm, Mm, Mm, Mm, Mm, Mm, Mm, Mm, Mm, Mm, Mm, Mm, Mm, Mm, Mm, Mm, Mm, Mm, Mm, Mm, Mm, Mm, Mm, Mm, Mm, Mm, Mm, Mm, Mm^Xm, Mm, Mm, Mm, Mm, Mm, Mm, Mm, Mm, Mm, Mm
Xv, Xv, Xv, 1 Xv, Xv, 2 Xv, Xv, 3 Xv, Xv, 4 Xv, Xv, 5 Xv, Xv, 6 Xv, Xv, Xv, Xv, Xv, Mm^Xm, Mm^Xm, Mm, Mm, Mm, Mm, Mm, Mm, Mm, Mm, Mm, Mm, Mm, Mm, Mm, Mm, Mm, Mm, Mm, Mm, Mm, Mm, Mm, Mm, Mm, Mm, Mm, Mm, Mm, Mm, Mm, Mm, Mm, Mm, Mm, Mm, Mm, Mm, Mm, Mm, Mm, Mm, Mm^Xm, Mm^Xm
Xv, Xv, Xv, Xv, Xv, Xv, Xv, Xv, Xv, Xv, Xv, Xv, Xv, Xv, Xv, Xv, Xv, Xv, Mm^Xm, Mm^Xm, Mm^Xm, Mm, Mm, Mm, Mm, Mm, Mm, Mm, Mm, Mm, Mm, Mm, Mm, Mm, Mm, Mm, Mm, Mm, Mm, Mm, Mm, Mm, Mm, Mm, Mm, Mm, Mm, Mm, Mm, Mm, Mm, Mm, Mm, Mm, Mm, Mm, Mm, Mm, Mm^Xm, Mm^Xm, Mm^Xm, Mm^Xm
