Wo, Wo, Wo, Wo, Wo, Wo, Wo, Wo, Wo, Wo, Wo, Wo, Wo, Wo, Wo, Wo, Wo, Wo, Wwr, Wwf, Gs^Fp, Aa, Ms, Ms, Gs^Fp, Aa^Fda, Gg, Gg, Gs^Fp, Gg, Gg, Gg, Gs^Fp, Wo, Wwr, Wo, Wo, Wo, Wo, Wwr, Gs^Fp, Wwf, Wwf, Wwf, Wwf, Gs^Fp, Wwf, Gs^Fp, Gs^Fp, Gs^Fp
Wo, Wo, Wo, Wo, Ww, Wo, Wo, Wo, Wo, Wo, Wo, Wo, Wo, Wo, Wo, Wo, Wo, Wo, Wo, Wwf, Gs^Fp, Ha^Fpa, Ha, Ha, Gs^Fp, Aa^Fda, Gs^Fp, Rd, Rd, Re^Gvs, Gg, Gs^Fp, Re, Gg^Efm, Wwr, Wwr, Wo, Ww, Wo, Wwr, Gs^Fp, Gs^Fp, Wwf, Gs^Fp, Wwf, Gs^Fp, Aa, Gs^Fp, Aa, Aa^Fpa
Wo, Ww, Ww, Ww, Ww, Ww, Wo, Wo, Wo, Wo, Wo, Wo, Wo, Wwf, Wo, Wo, Wo, Wo, Wo, Gs^Vht, Re^Gvs, Aa, Aa, Aa, Gs^Fp, Gs^Fp, Rr, Aa^Fpa, Rd, Gg^Wm, Gs^Fp, Gs^Fp, Gs^Fp, Gg^Efm, Gs^Fp, Wo, Wo, Wo, Wo, Gs^Fp, Gs^Fp, Wwf, Gs^Fp, Wwf, Wwf, Gs^Fp, Aa^Fpa, Rd, Ai, Aa
Wo, Wo, Wo, Ww, Ww, Wo, Wo, Wo, Wo, Wo, Wwr, Wo, Aa, Wo, Wo, Wo, Ww, Wo, Wo, Wwf, Wwf, Gs^Fp, Gg^Efm, Rd, Rd, Rr, Re^Gvs, Gs^Vht, Rd, Rd, Rd, Gs^Fp, Gg, Re^Gvs, Re^Gvs, Gg, Wo, Wo, Gs^Fp, Gs^Fp, Re^Gvs, Gs^Fp, Gs^Vht, Gs^Fp, Gs^Fp, Aa, Aa, Ai, Aa^Fpa, Aa
Wo, Wo, Wo, Ww, Wo, Wo, Wo, Wo, Wo, Wwf, Gg^Efm, Aa, Wwf, Wwr, Wo, Wo, Ww, Wo, Wo, Wo, Wwf, Gg, Gs^Fp, Gs^Fp, Gg^Efm, Rd, Gg, Re^Gvs, Gg, Gs^Fp, Gs^Fp, Hh, Gs^Fp, Re^Gvs, Re^Gvs, Gs^Fp, Wo, Wwr, Wwr, Wwr, Wwr, Wo, Wo, Wwr, Wwr, Aa, Rr, Ai, Aa^Fpa, Aa^Fpa
Wo, Wo, Ww, Ww, Wo, Wo, Wo, Wo, Wwf, Wwf, Aa, Gg^Efm, Wwf, Wo, Wo, Wo, Ww, Wo, Wo, Wo, Wwr, Gg, Gs^Fp, Rd, Gg, Gs^Fp, Wwr, Gs^Fp, Hh, Gg, Ww, Gs^Fp, Gs^Fp, Hh, Rr, Gs^Vht, Wo, Wo, Wo, Wwr, Wo, Wo, Wo, Wo, Wo, Wwr, Gs^Vht, Re, Aa^Fpa, Aa
Wo, Wo, Wo, Wo, Wo, Wo, Wo, Wo, Wo, Wo, Gg^Vl, Re^Gvs, Ha, Wo, Wo, Wo, Ww, Ww, Ww, Wo, Wo, Wwr, Wwr, Gg, Wo, Wo, Wo, Wo, Wo, Rr, Re^Gvs, Wwf, Gs^Fp, Gs^Fp, Wwr, Wo, Ww, Wo, Wo, Wo, Gs^Fp, Gs^Fp, Gs^Vht, Gs^Fp, Gs^Fp, Gs^Fp, Gs^Fp, Re^Gvs, Gg^Efm, Aa^Fpa
Wo, Wo, Wo, Wo, Wo, Wo, Wwr, Wo, Wo, Aa, Gs^Fp, Ha, Rd, Wo, Wo, Wo, Wo, Ww, Ww, Wo, Wo, Wwr, Wo, Wo, Wo, Wo, Gg, Wo, Wo, Gs^Vht, Gg, Gs^Fp, Gg, Gs^Fp, Wo, Wo, Wo, Wo, Wwr, Wo, Wo, Wo, Gg, Re^Gvs, Gg, Re^Gvs, Gg, Gs^Fp, Gs^Fp, Ai
Wo, Wo, Wo, Wo, Wo, Wwr, Ha, Gg^Vl, Ww, Gg, Rr, Rr, Hh, Wwr, Wo, Wo, Wo, Ww, Ww, Wo, Wo, Wo, Wo, Wo, Gg, Gg^Efm, Gg, Wo, Wo, Gs^Fp, Gs^Fp, Gs^Fp, Gs^Fp, Gs^Fp, Wwr, Wo, Wo, Wo, Wo, Wwr, Wwr, Wo, Re, Gs^Fp, Gg, Gs^Fp, Aa, Aa, Aa^Fpa, Ai
Wo, Wo, Wo, Wo, Wo, Wo, Gs^Fp, Gg, Wo, Wo, Gg, Re^Gvs, Gg, Wwr, Wo, Wo, Wo, Wo, Ww, Wo, Wo, Wo, Wwr, Wwr, Gg, Re^Gvs, Gs^Vht, Wo, Wwf, Gg, Gs^Fp, Gs^Fp, Gs^Fp, Gs^Fp, Wo, Wo, Wo, Wo, Wwr, Gg, Re^Gvs, Gs^Vht, Re, Re, Gs^Fp, Gs^Fp, Gg^Wm, Rd, Gg^Efm, Gg
Wo, Wo, Wo, Wwr, Gg^Efm, Gs^Fp, Re^Gvs, Rr, Wo, Wo, Gg^Vl, Gs^Fp, Re^Gvs, Gg, Wwr, Wwr, Wo, Wo, Ww, Ww, Wo, Wo, Wo, Wwr, Gg, Re^Gvs, Wwf, Wwf, Re^Gvs, Re^Gvs, Wo, Gg, Wwr, Gg, Wo, Wo, Wo, Wwr, Gg, Gg^Efm, Gs^Fp, Gg, Aa, Gs^Fp, Gg, Re, Aa^Fpa, Re, Gg, Aa
Wo, Wo, Wo, Wwr, Gg^Vl, Re^Gvs, Gs^Fp, Gg^Vl, Wo, Wo, Gg^Efm, Rr, Gg^Efm, Gg, Gg^Efm, Wo, Wo, Wo, Ww, Wo, Wwr, Wo, Wo, Wwr, Gg^Efm, Gs^Fp, Gg, Wwf, Gg, Gs^Vht, Wo, Wo, Wo, Wwr, Wo, Wo, Wo, Wwr, Gs^Fp, Gg, Gs^Fp, Gs^Fp, Aa^Fpa, Gg, Re^Gvs, Aa, Gg, Aa, Gs^Vht, Aa^Fpa
Wo, Wo, Wo, Wo, Wo, Hh, Wwr, Gg, Wo, Gg, Re^Gvs, Rr, Rr, Gg^Wm, Gg, Wwr, Wwr, Wo, Wo, Wo, Wo, Wwr, Wo, Wwr, Gs^Vht, Re^Gvs, Wwf, Wwf, Wo, Wo, Ww, Wo, Wo, Wo, Wo, Wo, Wo, Wo, Gg^Efm, Gg, Rr, Gg, Gg, Gg, Gg, Gg, Aa^Fpa, Gg, Aa, Gg
Wo, Wo, Wo, Wo, Wo, Wwr, Wo, Wo, Gg, Gs^Fp, Rr, Gg^Vl, Re^Gvs, Rr, Rr, Wwr, Wo, Wo, Wo, Wo, Gg^Vl, Gg, Re^Gvs, Gg, Re^Gvs, Gs^Fp, Wwf, Wo, Gg^Efm, Wo, Wo, Ww, Wo, Wwr, Wwr, Wo, Re^Gvs, Gg, Gg, Gs^Vht, Gg, Aa^Fpa, Gg, Aa^Fpa, Re, Gg, Gg, Aa, Re, Aa^Fpa
Wo, Wo, Ww, Wo, Wo, Wo, Wo, Gg^Efm, Wo, Gg, Re^Gvs, Re^Gvs, Gg^Efm, Re^Gvs, Gg^Vl, Gg, Wwr, Wo, Wwr, Wo, Gg^Efm, Gg^Efm, Gg^Efm, Re^Gvs, Rd, Gg, Gs^Fp, Gg, Gs^Fp, Wo, Gg, Wo, Gg^Efm, Gg, Wwr, Wo, Re^Gvs, Gg, Re^Gvs, Gg, Gs^Fp, Gg, Gs^Vht, Gg, Re, Re, Gs^Vht, Re, Gg, Gg
Wo, Ww, Ww, Ww, Ww, Wo, Wwr, Wo, Gg, Gg^Efm, Gg, Gg, Wwr, Gg, Gg, Wo, Wo, Wo, Re^Gvs, Gg, Gg^Efm, Gg^Efm, Hh, Gg, Gg, Hh, Re^Gvs, Gg, Re, Gg, Gs^Fp, Rd, Rd, Re^Gvs, Gg, Gg, Re^Gvs, Gs^Fp, Gg, Gg, Gg, Rr, Rr, Aa^Fpa, Gg, Re, Hh, Re, Aa, Aa
Wo, Wo, Wo, Ww, Ww, Wo, Wwr, Gg^Efm, Wo, Wwr, Wo, Wo, Wo, Ww, Wo, Wwf, Wo, Gg^Efm, Rr, Gg, Re^Gvs, Re^Gvs, Gg, Gs^Fp, Gg, Re^Gvs, Hh, Gs^Vht, Re, Hh, Rd, Re^Gvs, Gg, Gg, Gg^Vl, Re^Gvs, Re^Gvs, Re^Gvs, Gs^Fp, Gg, Gg, Gs^Fp, Gg, Gg, Re^Gvs, Gg, Gg, Gg, Gs^Fp, Aa
Wo, Wo, Wo, Ww, Wo, Wo, Wo, Wo, Wo, Wo, Wo, Wo, Gg^Efm, Wo, Wo, Wo, Gg^Efm, Gg, Hh, Gg^Vl, Re^Gvs, Re^Gvs, Gs^Fp, Gg, Gg, Gs^Fp, Gg, Re, Gs^Fp, Re, Re, Rd, Re, Re, Re^Gvs, Re^Gvs, Gg, Gg, Gg, Gg, Gg, Hh, Gg^Efm, Re^Gvs, Re, Re^Gvs, Gs^Fp, Gg, Gg, Gg
Wo, Wo, Ww, Ww, Wo, Wo, Wo, Wo, Wwr, Re, Re, Re, Rr, Gs^Fp, Re^Gvs, Gg, Re^Gvs, Re^Gvs, Gg^Efm, Gg, Gg, Rr, Gs^Vht, Hh, Re, Rd, Gg^Efm, Hh, Gg, Gg, Gs^Fp, Re, Hh, Gs^Fp, Hh, Re, Re, Hh, Gs^Fp, Gs^Fp, Gg, Gg, Gg, Re, Gs^Vht, Gg, Re, Gg^Efm, Gs^Fp, Gg
Wo, Wo, Ww, Ww, Ww, Wo, Wo, Wo, Wo, Wo, Wo, Gg, Re^Gvs, Gg^Efm, Re^Gvs, Re^Gvs, Rr^Vhc, Gg^Efm, Gg^Efm, Gg^Efm, Gg^Wm, Gg, Gs^Fp, Hh^Fmw, Hh^Fmw, Rd, Re^Gvs, Gg, Rr, Rr, Rr, Gg^Vl, Gg, Gg, Gg^Vl, Gg, Gs^Fp, Re, Gg, Rd, Gg^Efm, Gs^Fp, Gg, Rr, Rr, Rr, Rr, Re^Gvs, Gs^Vht, Gg
Wo, Wo, Ww, Ww, Ww, Ww, Wo, Wo, Wo, Wo, Ww, Rr^Vhc, Rr, Rr, Gg^Efm, Gg, Rr, Re^Gvs, Gg, Gs^Fp, Gs^Fp, Hh^Fmw, Hh, Hh^Fmw, Re^Gvs, Re^Gvs, Gg, Gs^Vht, Rd, Gg^Efm, Gg, Re^Gvs, Re^Gvs, Rr, Gs^Fp, Hh, Gg, Hh, Hh, Gg, Gg, Gg, Gg, Re^Gvs, Gg, Gs^Fp, Re^Gvs, Rr, Rr, Rr
Wo, Wo, Ww, Ww, Ww, Ww, Wo, Wo, Wo, Wo, Wo, Wo, Gg, Re^Gvs, Gg, Gs^Fp, Gs^Fp, Rr, Hh, Gg^Efm, Re^Gvs, Re^Gvs, Gg, Gg, Rr^Vhc, Re^Gvs, Mm, Rd, Rd, Gg, Hh, Gg, Gg, Rr, Rr, Rr, Re, Re, Gg^Efm, Gs^Fp, Gg^Wm, Hh^Fmw, Gg^Efm, Gg^Efm, Re^Gvs, Re^Gvs, Re^Gvs, Re^Gvs, Gg, Gg
Wo, Wo, Wo, Wo, Wo, Wo, Wo, Wo, Wo, Wo, Wo, Wo, Rr^Vhc, Rr, Hh, Gg, Re^Gvs, Rr, Rr^Vhc, Gg^Efm, Hh, Rr^Vhc, Mm^Xm, Mm^Xm, Mm^Xm, Mm^Xm, Hh, Mm, Re, Hh, Gg^Efm, Hh^Fmw, Hh^Fmw, Hh, Gg, Gg^Vl, Gg, Re, Gg^Efm, Gg^Efm, Gg^Efm, Hh, Hh^Fmw, Gg, Gg, Gg, Gs^Vht, Re^Gvs, Gg, Gs^Fp
Wo, Wo, Wo, Wo, Wo, Wo, Wo, Wo, Wwr, Wo, Wo, Wo, Gs^Fp, Gs^Fp, Gg, Gs^Fp, Gg, Re^Gvs, Re^Gvs, Gg, Hh, Mm, Gg, Rd, Rr^Vhc, Hh, Gg, Re, Wwr, Re, Gg, Gg^Efm, Gg^Efm, Gg, Hh, Rr, Gs^Fp, Gs^Fp, Gs^Fp, Gg^Efm, Rr, Hh, Hh, Gs^Fp, Gg, Rr, Wwr, Rr, Gg^Efm, Gg
Wo, Wo, Wwr, Wwr, Hh, Wo, Hh, Wwr, Hh, Wwr, Wo, Wo, Gg, Re^Gvs, Re^Gvs, Rd, Gs^Fp, Gg^Efm, Re^Gvs, Re^Gvs, Rr, Hh, Re^Gvs, Re^Gvs, Gg^Efm, Re, Gg^Efm, Gg^Efm, Wo, Wo, Wo, Gg, Gg, Gg, Gg, Gg, Gg, Hh^Fmw, Gg, Rr, Gs^Vht, Rd, Gg, Re^Gvs, Gg, Wo, Wwr, Wwr, Gg, Gg^Efm
Wo, Wo, Wwr, Hh, Hh, Hh, Re, Hh, Re^Gvs, Hh, Gg, Hh, Mm, Gg, Hh, Gg, Gg, Re^Gvs, Rr^Vhc, Gg^Efm, Wwr, Rr^Vhc, Gg, Gg^Efm, Gg^Efm, Re, Re, Gs^Fp, Wo, Wo, Wo, Gs^Fp, Gg, Re^Gvs, Re^Gvs, Gg, Gg, Hh, Hh^Fmw, Rd, Re^Gvs, Hh, Rr, Gs^Vht, Wo, Wo, Wo, Wo, Wwr, Wo
Wo, Wo, Wwr, Wwr, Hh, Re^Gvs, Re, Re^Gvs, Re, Re, Re^Gvs, Gg^Efm, Gs^Fp, Hh, Rr^Vhc, Re^Gvs, Wo, Gg^Efm, Wo, Wo, Wo, Wo, Wo, Wo, Wo, Re^Gvs, Re, Hh^Fp, Mm, Wo, Wo, Hh^Fmf, Hh^Fmf, Gg, Gs^Fp, Hh^Fp, Rr^Vhc, Rd, Re^Gvs, Gg, Hh, Hh^Fmw, Re^Gvs, Gg^Efm, Ww, Wo, Ww, Wo, Wo, Wo
Wo, Wo, Wo, Wo, Rr^Vhc, Rr, Re, Hh^Fp, Rr^Vhc, Rr, Gg, Re^Gvs, Hh, Rr, Wwr, Wo, Wo, Wo, Wo, Wo, Ww, Wo, Wo, Wo, Wo, Gg, Rr^Vhc, Rr, Re, Wo, Wo, Wo, Wo, Mm, Gg, Rr, Rr, Gg, Rd, Re, Re^Gvs, Re^Gvs, Re^Gvs, Gg, Ww, Wo, Wo, Wo, Wo, Wo
Wo, Wo, Wo, Wwr, Re^Gvs, Gs^Fp, Re, Gg^Efm, Re, Hh, Gs^Fp, Re^Gvs, Rr, Rr, Wo, Wwr, Wo, Wo, Ww, Ww, Wo, Ww, Wo, Hh^Fms, Wo, Wo, Wwr, Re^Gvs, Hh^Fp, Re, Rr^Vhc, Wo, Wo, Wo, Hh, Gg, Gg, Hh^Fp, Rr^Vhc, Re^Gvs, Gg, Gg^Efm, Ww, Rr^Vhc, Re^Gvs, Ww, Gg^Efm, Wo, Hh, Wo
Wo, Wo, Wwr, Wwr, Rr, Re, Re^Gvs, Gg^Efm, Gs^Fp, Re^Gvs, Re, Re, Re, Rr^Vhc, Wo, Wo, Wo, Wo, Ww, Ww, Wo, Wo, Wo, Wo, Ww, Wo, Wo, Wo, Hh^Fp, Re^Gvs, Wo, Gg^Efm, Wo, Wo, Wwr, Hh^Fms, Hh, Re^Gvs, Wo, Wo, Wo, Wo, Wo, Ww, Hh, Gg, Rd, Rr, Rr^Vhc, Gg
Wo, Wo, Wwr, Rr^Vhc, Re^Gvs, Re, Re^Gvs, Re, Rr, Re, Gg^Wm, Gg^Efm, Hh, Gg, Wwr, Wwr, Wo, Wo, Wo, Wo, Wo, Wo, Wo, Hh, Ww, Wo, Wo, Wo, Hh^Fp, Gg, Wwr, Wo, Wo, Wo, Wo, Wwr, Hh^Fms, Gg^Efm, Wo, Wo, Wo, Wwr, Wo, Wo, Rr^Vhc, Rr, Hh, Re^Gvs, Re^Gvs, Gg
Wo, Wo, Wo, Wo, Gg, Re^Gvs, Gs^Fp, Rr^Vhc, Gg, Hh, Hh, Hh, Wo, Wwr, Wo, Wo, Wo, Wo, Wo, Wo, Wwr, Wo, Wo, Wo, Wo, Wo, Hh, Wo, Wo, Wo, Wo, Wo, Wo, Wo, Wo, Wwr, Mm, Rr^Vhc, Wo, Wo, Wwr, Wwr, Wo, Wo, Wo, Re^Gvs, Gs, Gg^Efm, Re, Gg
Wo, Wo, Wo, Wo, Wwr, Wwr, Wo, Gg^Efm, Wo, Wo, Wo, Wo, Wo, Wo, Wo, Wo, Rd, Gg, Rd, Gg, Gg^Efm, Gg, Wo, Wo, Wo, Rr^Vhc, Wo, Wo, Wo, Wo, Wo, Wo, Ww, Wo, Ww, Wo, Wo, Wwr, Hh^Fds, Wo, Wo, Wo, Wo, Wo, Wwf, Gg, Hh, Gg^Efm, Mm, Gs
Wo, Wo, Wo, Wo, Wo, Wo, Wwr, Wo, Wo, Wo, Wo, Wo, Gg, Gg, Rd, Rd, Dd, Rd, Gg, Gg^Efm, Gg, Gg, Wwr, Wo, Wo, Wo, Wo, Wo, Ww, Wo, Ww, Ww, Ww, Ww, Ww, Wo, Wo, Wo, Wo, Hh^Fds, Wwr, Wwr, Wwf, Wwr, Wwf, Wo, Wo, Hh, Wo, Gg
Wo, Wo, Wo, Wo, Wwr, Wwr, Gg, Gg^Efm, Gg^Efm, Gg, Rd, Gg, Dd, Dd, Dd, Dd, Dd^Do, Gs, Gs, Gs, Gs, Wwr, Wo, Wo, Wo, Wo, Wo, Wo, Wo, Ww, Wo, Wo, Wo, Wo, Wo, Ww, Wo, Wo, Wo, Wo, Wo, Wo, Wo, Wo, Wo, Wo, Wo, Wo, Wo, Wo
Wo, Wo, Wo, Wo, Ww, Gg, Gg^Efm, Gg^Efm, Gg^Efm, Rd, Dd, Dd, Dd, Dd, Dd, Dd, Dd, Dd, Gs, Gs, Gs, Ww, Wo, Wo, Wo, Wo, Wo, Wo, Wo, Wo, Wo, Wo, Wo, Wo, Wo, Wo, Wo, Wo, Wo, Wo, Wo, Wo, Wo, Wo, Wo, Wo, Wo, Wo, Wo, Wo
