Wo, Wo, Wo, Wo, Wo, Wo, Wo, Wo, Wo, Wo, Wo, Wo, Wo, Wo, Wo, Wo, Wo, Wo, Wo, Wo, Wo, Wo, Wo, Wo, Wo, Wo, Wo, Wo, Wo, Wo, Wo, Wo, Wo, Wo, Wo, Wo, Wo, Wo, Wo, Wo, Wo, Wo, Wo, Wo, Wo, Wo, Wo, Wo, Wo, Wo, Wo, Wo, Wo, Wo, Wo, Wo, Wo, Wwr, Wwr, Gg, Gg, Gs^Fp, Gs^Fp, Gs^Fdw, Gs^Fp, Gs^Fp, Gs^Fdw, Gs^Fp, Gs^Fp, Gs^Fp, Gs^Fp, Gg
Wo, Wo, Wo, Wo, Wo, Wo, Wo, Wo, Wo, Wo, Wo, Wo, Wo, Wo, Wo, Wo, Wo, Wo, Wo, Wo, Wo, Wo, Wo, Wo, Wo, Wo, Wo, Wo, Ww, Ww, Ww, Ww, Ww, Wo, Wo, Wo, Wo, Wo, Wo, Wo, Wo, Wo, Ww, Wo, Ww, Wo, Ww, Wo, Wo, Wo, Wo, Wo, Wo, Wo, Wwr, Wwr, Wwf, Wo, Wo, Gg, Gg^Efm, Gs^Fds, Gs^Fdf, Gs^Fdw, Gs^Fp, Gs^Fp, Gg^Efm, Re^Gvs, Rp^Vhc, Re^Gvs, Gg, Gg
Wo, Wo, Wo, Wo, Wo, Wo, Wo, Wo, Wwr, Wo, Wo, Wo, Wwr, Wwr, Wwr, Wo, Wo, Wo, Wo, Wo, Wo, Wo, Ww, Wo, Wo, Wo, Ww, Ww, Wwr, Ww, Wwr, Ww, Wo, Wo, Ww, Wo, Wo, Wo, Wo, Wo, Wwr, Wwr, Wwr, Wwr, Wo, Ww, Wo, Wo, Wo, Wo, Wo, Wo, Wo, Wo, Wo, Wo, Rp^Vhc, Wo, Wwf, Wo, Wo, Gg, Gg, Gs^Fdw, Rp^Vhc, Re^Gvs, Gg, Gg, Wo, Wo, Wo, Wwf
Wo, Wo, Wo, Wo, Wo, Wo, Wo, Wwr, Gg, Wo, Gg^Vl, Wo, Gg, Wwr, Gg, Wo, Wo, Wo, Wo, Wo, Wo, Wo, Wwr, Ww, Wwr, Ww, Wwr, Wwr, Wo, Wwr, Wo, Wo, Wo, Wwr, Wo, Wo, Wo, Wo, Wo, Wwr, Wo, Ww, Wo, Wo, Wo, Wo, Wo, Wo, Wo, Wo, Wwr, Wwr, Wwr, Wo, Gg, Gg, Re^Gvs, Gg, Gg, Wo, Wwf, Wwf, Wo, Gg, Gg, Gg^Efm, Gg, Wwf, Gg, Gg^Efm, Gg^Efm, Gg
Wo, Wo, Wo, Wo, Wo, Wo, Wo, Wo, Gg, Gs, Rp, Gg^Efm, Re^Gvs, Mm, Gs^Fds, Gg, Gg^Vl, Wwf, Wo, Wo, Wo, Wo, Wo, Wwr, Wo, Wwr, Wo, Wo, Wo, Wo, Wo, Wo, Wo, Wo, Wo, Wo, Wo, Wo, Wo, Wo, Wo, Wo, Wo, Wo, Wo, Wo, Wo, Wo, Wo, Wo, Wo, Wo, Wwr, Wwr, Gg^Efm, Gg^Efm, Gs^Fdw, Gs^Fdw, Gs^Fdw, Gg, Gg, Rp, Wwf, Wwf, Wo, Rp, Wo, Wwf, Gg, Gg^Efm, Gg, Gg
Wo, Wo, Wo, Wo, Wo, Wo, Wwr, Wo, Wwr, Re, Re, Rp, Rp, Rd, Hh^Fdf, Re^Gvs, Gg, Wo, Wo, Wo, Wo, Wo, Wo, Wo, Wo, Wo, Wo, Wo, Wo, Wo, Wo, Wo, Wo, Wo, Wo, Wo, Wo, Wo, Wwr, Wo, Wo, Wo, Wo, Wwr, Wo, Wo, Wwr, Wo, Wo, Wo, Wo, Wo, Wwr, Gg, Gg, Gs^Fdf, Gs^Fdw, Gs^Fds, Ce, Gs^Fp, Gs^Fp, Gg^Efm, Rp, Wwf, Wo, Wwf, Wo, Rp, Gg, Gg, Gs^Fdf, Gs^Fp
Wo, Wo, Wo, Wo, Wwf, Wo, Gg, Wo, Wo, Gg, Re^Gvs, Gs^Fdf, Rp, Hh, Gs^Fdw, Gs^Fds, Gg, Wwf, Wwr, Wo, Wo, Wo, Wwr, Wo, Wo, Wo, Wo, Wo, Wwr, Wo, Wwr, Wo, Wo, Wwr, Wwr, Wo, Wo, Wo, Wo, Wo, Wo, Ch, Rp^Vhc, Ch, Wo, Wo, Gg, Wwr, Wo, Wo, Wo, Wwr, Wo, Gg, Gg, Gs^Fp, Re^Gvs, Ce, Rp^Vhc, Gg, Gg, Gg^Efm, Gg^Efm, Wwf, Rp, Wwf, Rp^Vhc, Gg, Gg, Re^Gvs, Gs^Fdf, Gs^Fp
Wo, Wo, Wwr, Wwr, Gg^Efm, Gg^Vl, Gg, Wo, Wo, Gg^Efm, Gs^Fds, Gs^Fdf, Rp, Gg^Efm, Gg, Hh^Fdf, Gs^Fdw, Gg, Wwr, Wwr, Wo, Wwr, Wo, Wo, Wo, Wo, Wwr, Rp, Rp, Wwr, Wo, Wo, Wwr, Wwr, Wwr, Wo, Gg^Efm, Gg^Efm, Wo, Gg, Gg^Efm, Ch, Gg^Efm, Ch, Wo, Gg^Efm, Gg^Efm, Gg, Wwf, Wo, Wo, Wo, Wo, Wo, Wo, Gg^Efm, Gg^Efm, Gg, Ce, Ce, Re^Gvs, Gg^Wm, Gg, Gg, Gg, Gg, Gg, Re^Gvs, Gg, Gs^Fds, Gs^Fdf, Gs^Fdw
Wo, Wo, Wo, Wwr, Wwf, Re, Re^Gvs, Wo, Wo, Gg^Efm, Gs^Fdf, Gs^Fds, Gg^Efm, Rp, Gg^Vl, Hh^Fdf, Gs^Fds, Gs^Fdf, Gs^Fdf, Ch, Gg^Vl, Ch, Wwr, Wo, Wo, Wo, Ch, Wwf, Wwf, Ce, Gg^Vl, Ce, Gg^Efm, Wwr, Gg, Gg^Efm, Gg, Rp, Rp^Vhc, Wo, Rp, Gg^Efm, Re^Gvs, Gg^Efm, Gg, Wwf, Gg, Gg^Efm, Gg, Wo, Ch, Ww, Wwf, Wo, Wo, Gg, Gg^Efm, Gs^Fdw, Re^Gvs, Re^Gvs, Re^Gvs, Re^Gvs, Gs^Fdw, Gg^Efm, Rp, Re^Gvs, Rp, Rd, Rp, Gs^Fdw, Rp, Rp
Wo, Wo, Wo, Wo, Wo, Gs^Fdf, Gg, Wo, Wo, Gg, Gg, Re^Gvs, Gg^Wm, Gs^Fdf, Re^Gvs, Rp, Re^Gvs, Gs^Fdw, Rp, Ch, Rd, Ch, Wwr, Wo, Wo, Ch, Gg^Vl, Wo, Wwf, Ce, Rr, Ce, Hh, Gg, Gs^Fdw, Re^Gvs, Gg^Efm, Re^Gvs, Hh, Wwf, Wo, Gs^Fds, Gg, Gs^Fmf, Gg, Wo, Gg, Gg^Efm, Hh, Ch, Rp^Vhc, Wo, Rp, Wo, Wwf, Wwf, Gg, Gg^Efm, Gg^Efm, Gg^Efm, Rp, Rp, Rp, Rp, Gg^Efm, Rp, Gg, Rp, Gs^Fmf, Rp, Rp, Gs^Fp
Wo, Wo, Wo, Wo, Wo, Gs^Fds, Gg, Wo, Wo, Wwr, Gg, Gg, Gg, Gg^Efm, Gs^Fdw, Rp, Rp, Rp, Wwf, Rp, Wwf, Wwr, Wo, Wo, Wwr, Rp, Ch, Ch, Wwf, Gg^Efm, Hh, Hh^Fmf, Mm, Hh^Fdf, Hh, Gs^Fds, Re, Re, Hh^Fp, Rp, Wwf, Hh, Re, Rr, Rr, Wo, Wwf, Gg, Re^Gvs, Hh, Ch, Ch, Rp, Wo, Wo, Wwf, Wo, Gg, Rp^Vhc, Gg, Gg^Efm, Gg, Gg, Gg, Gg^Efm, Gg, Rp^Vhc, Gs^Fdf, Gs^Fdf, Gg, Rp, Gg
Wo, Wo, Wo, Wo, Wwr, Wo, Gg, Gg^Efm, Wwr, Wo, Wo, Wo, Wo, Wwf, Gs^Fdf, Gs^Fdf, Gs^Fds, Rp, Wwf, Wo, Wo, Wo, Wo, Wo, Gg^Efm, Gg^Efm, Rd, Gg^Efm, Wwf, Gg, Hh^Fp, Mm, Hh^Fdw, Hh^Fdf, Gs^Fdf, Gs^Fms, Re, Gs^Fmf, Hh, Gs^Fmw, Hh, Wo, Wo, Rr, Wo, Rr, Wwf, Gg, Gg^Efm, Hh^Fdf, Hh^Fp, Gg, Gg, Rp, Rp, Wo, Wwf, Gg, Re^Gvs, Re, Gs^Fdw, Gg, Gs^Fds, Gg, Gg, Gg, Re^Gvs, Gg, Rp, Rp, Gg^Efm, Gg
Wo, Wo, Wo, Wo, Wo, Wwr, Wo, Wo, Wo, Wo, Wo, Wwf, Gg^Vl, Gg, Gg, Gg, Gg, Gg, Wo, Wo, Ch, Wwr, Gg, Re^Gvs, Re^Gvs, Re, Re^Gvs, Gg, Wo, Gg^Efm, Gg, Rp, Rr, Re, Rr, Rr, Rp, Hh^Fdf, Hh^Fdf, Mm, Rp, Rp, Wwf, Rp^Vhc, Wo, Wo, Gg, Wwf, Gg, Hh, Hh^Fdf, Gg, Re^Gvs, Gg^Efm, Gg, Wo, Wo, Gg, Gg, Gg, Gs^Fp, Gs^Fdw, Gs^Fdw, Gs^Fdf, Gg, Gg, Re, Rp, Re, Gg^Efm, Rd, Mm
Wo, Wo, Wo, Wo, Wo, Wwr, Wo, Wo, Wo, Wo, Wwr, Wo, Wwr, Gg, Wo, Wwr, Wwr, Wwr, Wo, Wo, Gg^Vl, Ch, Re, Re, Hh^Fdw, Re^Gvs, Gg, Rp, Gg^Vl, Wo, Hh, Mm, Hh, Gg^Vl, Hh^Fdw, Ms, Ms, Rp, Rp, Rp, Hh, Mm, Hh, Wwf, Wwf, Re^Gvs, Gg^Efm, Wwf, Gg, Gs^Fdw, Gs^Fdw, Gs^Fmf, Gg, Gg^Efm, Gg^Efm, Gg, Gg, Wwf, Wo, Gg, Ce, Gs^Fdw, Gg^Efm, Gs^Fdw, Re^Gvs, Gg^Efm, Rp, Rp, Gg, Gg, Gs^Fds, Mm
Wo, Wo, Wo, Wo, Wo, Wo, Wo, Wo, Wo, Wwr, Wo, Wo, Wo, Wo, Wo, Wo, Wo, Wo, Wo, Ch, Ch, Rr, Hh, Hh^Fmf, Mm, Hh, Mm, Re^Gvs, Gg, Wo, Wwf, Mm, Mm, Rp, Gs^Fmf, Gs^Fmf, Ms, Mm, Rd, Rd, Rr, Mm, Mm, Hh^Fp, Hh, Gs^Fmf, Gg, Wo, Rr, Gs^Fdw, Hh, Hh^Fdf, Hh^Fdf, Gg^Vl, Gg^Efm, Gs^Fdf, Gg^Efm, Gg, Wwf, Wo, Rp^Vhc, Ce, Gg, Gg^Efm, Gg^Efm, Gg^Efm, Rp, Gg, Re^Gvs, Gs^Fmw, Gs^Fmw, Gs^Fds
Wo, Wo, Wo, Wo, Wo, Wo, Wo, Wo, Wo, Wo, Wo, Wo, Wo, Wo, Wo, Wo, Wo, Wo, Gg^Efm, Gg^Efm, Rd, Rr, Rr, Hh^Fds, Mm, Mm, Mm, Mm, Mm, Gg, Gg, Wwf, Wo, Hh, Hh, Mm, Mm, Ms, Mm, Hh^Fdw, Hh^Fds, Rr, Mm, Hh^Fp, Hh^Fp, Hh, Rp, Wo, Ch, Ch, Hh, Hh^Fdf, Hh, Gg^Efm, Gg^Efm, Gg, Re^Gvs, Rp, Wwf, Ce, Ce, Rr, Re, Gg^Efm, Gg^Efm, Rp, Gg, Rp^Vhc, Re, Re, Gs^Fmw, Gs^Fmw
Wo, Wo, Wo, Wo, Wo, Wo, Wo, Wo, Wo, Wo, Wo, Wo, Wo, Wwr, Wwr, Wwr, Ww, Wwr, Rp, Re, Hh^Fp, Hh, Mm, Rr, Rr, Gs^Fmw, Mm, Ms, Mm, Mm, Gs^Fmf, Wwf, Wwf, Wwf, Hh, Hh, Mm, Hh, Hh^Fds, Mm, Mm, Rr, Gg^Vl, Re^Gvs, Hh^Fms, Hh^Fms, Hh, Wwf, Wo, Gg^Vl, Ch, Rp, Rp, Hh^Fdf, Rp, Rp, Rp, Rp, Wwf, Wwf, Gg, Gg, Gg, Re, Rp, Rp, Re^Gvs, Gg, Gs^Fmw, Gg^Efm, Gs^Fmw, Gs^Fmw
Wo, Wo, Wo, Wo, Wo, Wo, Wo, Wo, Wwr, Wo, Wo, Wwr, Wwr, Wwr, Gg^Efm, Wo, Gg, Gg^Vl, Gs^Fmw, Hh^Fds, Hh^Fdf, Mm, Mm, Ms, Mm, Gg^Vl, Rr, Mm, Re, Re, Re, Rr, Gg, Wo, Wo, Hh, Gs^Fmf, Hh, Gs^Fmf, Hh, Rr, Rr, Gs^Fmf, Rp, Rd, Hh^Fms, Gs^Fmf, Wwf, Wwf, Ch, Rr, Hh^Fp, Hh^Fp, Rp, Re^Gvs, Gs^Fmf, Hh^Fdf, Gg, Wo, Wo, Gg^Efm, Re, Gg, Re, Rp, Re^Gvs, Gg, Re^Gvs, Gg, Gs^Fdf, Gs^Fdf, Gs^Fmw
Wo, Wo, Wo, Wo, Wo, Wo, Wo, Wo, Wo, Wo, Wo, Wwr, Gg, Gg, Gg, Gg^Efm, Gg, Re^Gvs, Hh^Fds, Hh^Fdf, Mm, Mm, Mm, Ms, Ms, Rr, Ms, Re, Mm, Mm, Mm, Gs^Fmw, Re^Gvs, Gg^Vl, Wwf, Rr, Rr, Rr, Rr, Rr, Hh^Fp, Hh^Fp, Hh, Hh^Fdf, Rr, Rr, Rr, Rr, Wwf, Gs^Fms, Rr, Hh, Gg, Re^Gvs, Gg^Efm, Gs^Fmw, Gg, Gg, Wo, Gg, Re^Gvs, Rp^Vhc, Gg, Rp, Gg, Rp, Gg, Gg, Re^Gvs, Gs^Fds, Gs^Fds, Gs^Fds
Wo, Wo, Wo, Wo, Wo, Wwr, Wwr, Wo, Wo, Wo, Gg, Gg, Gs^Fdf, Re, Gs^Fdf, Gg^Efm, Hh, Hh^Fds, Hh^Fp, Hh^Fmf, Hh^Fds, Rr, Rr, Mm, Mm, Rr, Mm, Ms, Mm, Ms, Mm, Gs^Fmf, Wwf, Wo, Gg, Gg, Hh, Mm, Mm, Hh^Fdw, Hh^Fdw, Hh, Hh^Fdf, Gs^Fmw, Wwf, Wwf, Wo, Wo, Wo, Wwf, Wo, Gg, Gg, Gg, Gg^Vl, Gg, Wo, Wwf, Gg, Gg, Gs^Fp, Re^Gvs, Gs^Fdw, Gg, Gg, Rp, Gg^Efm, Gg^Efm, Re^Gvs, Rp^Vhc, Gs^Fdf, Gs^Fmw
Wo, Wo, Wo, Wo, Wo, Wo, Rp, Gg, Gs^Fmw, Gg, Gs^Fms, Gs^Fms, Gs^Fms, Gs^Fdf, Hh, Gs^Fdf, Gs^Fdf, Hh, Gg^Efm, Hh, Rr, Rr, Gg, Hh, Mm, Rr, Rd, Mm, Mm, Mm, Mm, Wwf, Rp, Gg^Efm, Gs^Fdf, Gs^Fmw, Mm, Mm, Mm, Mm, Hh^Fp, Hh^Fp, Gs^Fdf, Gg, Gg^Vl, Wo, Wwf, Rr, Gg, Wo, Gg, Wwf, Wwf, Wo, Wo, Wo, Gg, Gg, Gs^Fdw, Gs^Fp, Gs^Fp, Gs^Fdw, Gg^Efm, Gg^Efm, Rp, Rp, Gg, Re^Gvs, Gs^Fds, Re^Gvs, Gs^Fds, Gs^Fds
Wo, Wo, Wwr, Wo, Wo, Wwr, Gg, Rp, Rp, Gs^Fmw, Gs^Fdf, Gg^Fet, Gs^Fmw, Gs^Fdf, Ce, Gg^Efm, Ce, Gg, Gg, Gg, Wwf, Gg^Vl, Rp, Gg^Efm, Rr, Rr, Mm, Mm, Gs^Fdf, Hh^Fdw, Hh^Fdw, Mm, Rp, Gs^Fdf, Mm, Mm, Mm, Mm, Mm, Mm, Mm, Gs^Fdf, Gs^Fmw, Re^Gvs, Wwf, Wwf, Rr, Re^Gvs, Gs^Fmw, Gg, Re, Gg, Gg^Efm, Gg, Gg^Efm, Gg, Gg, Gg, Re^Gvs, Gs^Fp, Re^Gvs, Re^Gvs, Gg, Rp, Ch, Ch, Re, Gg^Efm, Gg^Efm, Gs^Fmw, Gs^Fds, Gs^Fmf
Wo, Wo, Wo, Wo, Wwr, Gg, Re^Gvs, Gg^Vl, Gg^Efm, Gs^Fmw, Gs^Fmw, Gs^Fms, Gg^Efm, Gg^Efm, Ce, Gg^Vl, Ce, Wo, Wo, Wo, Wo, Wo, Rp, Rp, Rr, Mm, Hh, Hh^Fms, Re, Gs^Fdf, Hh^Fdw, Rp, Mm, Mm, Ms, Mm, Ms, Mm, Ms, Hh, Mm, Gs^Fdf, Rd, Hh, Gs^Fds, Rr, Gs^Fdf, Gs^Fmf, Rd, Ch, Gg^Vl, Ch, Gs^Fdw, Gg^Efm, Gg^Efm, Gg^Efm, Gg, Re, Rp, Re^Gvs, Gg, Re^Gvs, Rp, Rp, Gg, Rp^Vhc, Ch, Gs^Fmw, Gs^Fmf, Gs^Fdf, Re^Gvs, Gs^Fds
Wo, Wo, Wo, Wo, Gg, Gg, Gs^Fms, Gg^Efm, Gg^Efm, Gs^Fmw, Gg, Gg, Wwr, Wwr, Wwr, Wo, Wo, Wo, Wo, Wo, Wo, Wo, Wwr, Rr, Gg, Hh, Gg, Gs^Fdf, Re, Gg^Efm, Rp, Rp, Hh^Fdw, Mm, Rp, Mm, Mm, Ms, Ms, Mm, Mm, Mm, Rd, Rr, Hh^Fds, Rr, Hh^Fp, Hh^Fdf, Rd, Ch, Rd, Ch, Rd, Rd, Gg^Efm, Gg, Re, Rr, Gg^Wm, Gg, Re^Gvs, Gg^Efm, Rp, Gg^Efm, Gg^Efm, Ch, Rp, Gg, Gs^Fmf, Re^Gvs, Rd, Gs^Fds
Wo, Wo, Wwr, Wo, Gg, Gg^Efm, Wo, Wwr, Wwr, Gg, Gg, Wo, Wwr, Wwr, Wo, Wo, Wo, Wo, Wo, Wo, Wo, Wwr, Wwr, Wwr, Ch, Ch, Re^Gvs, Gg^Efm, Gg^Efm, Rp, Gs^Fds, Hh, Hh^Fdw, Mm, Mm, Mm, Rr, Re, Rr, Mm, Mm, Mm, Hh^Fdw, Rd, Hh^Fms, Re, Hh^Fp, Hh^Fds, Hh, Hh, Gg, Gg, Gg, Gg, Gg, Gg^Efm, Gg, Re, Re^Gvs, Re^Gvs, Rp, Rp, Rp, Gg, Rp, Re^Gvs, Gg^Efm, Rp, Gs^Fmw, Gs^Fmf, Rd, Gs^Fmf
Wo, Wo, Wo, Wwr, Wo, Wo, Wo, Wwr, Wo, Gg, Gg^Efm, Wo, Wo, Wo, Wo, Wo, Wo, Wo, Wo, Wo, Wo, Wwr, Wo, Ww, Wo, Gg^Vl, Ch, Gg, Wo, Gg^Efm, Wo, Wwf, Wwf, Rp, Rp, Re, Mm, Gg^Vl, Rr, Mm, Mm, Mm, Mm, Hh^Fdf, Re, Re, Gs^Fms, Hh^Fdf, Gs^Fdw, Gg, Re^Gvs, Re^Gvs, Re^Gvs, Re^Gvs, Re^Gvs, Gg^Efm, Gg^Efm, Re^Gvs, Rp, Rp, Gg, Gg, Gs^Fdw, Rp, Gs^Fmw, Gg^Efm, Gs^Fdf, Gs^Fmf, Gs^Fds, Gs^Fdf, Gs^Fdf, Gs^Fds
Wo, Wo, Wo, Wo, Wo, Wo, Wo, Wo, Wo, Gg^Vl, Wwf, Wo, Wo, Wo, Wo, Wo, Wo, Wo, Wo, Wo, Wo, Wo, Wo, Wo, Wo, Ch, Wwr, Wwr, Wo, Wo, Gg^Efm, Rp, Rp, Wwf, Hh^Fds, Mm, Mm, Mm, Mm, Re, Rr, Mm, Rr, Gs^Fmf, Re^Gvs, Gs^Fmw, Hh, Hh^Fms, Hh^Fdw, Gg, Gg, Gg^Efm, Gg, Rp, Rp, Gg, Rp, Rp, Rp, Rd, Rp, Gg^Efm, Gg^Efm, Gs^Fds, Gs^Fdw, Re^Gvs, Gs^Fmf, Gs^Fmf, Gs^Fdf, Gs^Fmw, Gs^Fds, Gs^Fds
Wo, Wo, Wwr, Gg, Wo, Wwr, Wo, Wo, Wo, Wwf, Wwr, Wo, Wo, Wo, Ww, Wo, Wo, Wo, Ww, Wo, Wo, Wo, Wo, Wo, Wo, Wwr, Wo, Wwr, Wo, Gg^Efm, Gg^Efm, Gg, Gg, Rp, Hh, Hh^Fds, Mm, Mm, Mm, Mm, Mm, Rr, Hh, Rr, Gg^Vl, Rr, Gg, Hh, Hh, Hh^Fms, Rr, Gg^Efm, Rp, Rp^Vhc, Rp, Rp, Gg^Efm, Re^Gvs, Gg^Efm, Rp, Gg^Efm, Rp, Rp, Rp^Vhc, Gg^Efm, Gs^Fmw, Gg^Efm, Gg^Efm, Re^Gvs, Rp, Gs^Fmw, Gs^Fmw
Wo, Wo, Wo, Wo, Wo, Wo, Wwr, Wo, Wo, Wo, Wo, Wo, Wo, Wwr, Wo, Wo, Wo, Ww, Ww, Ww, Wo, Wo, Wo, Wo, Wo, Wo, Wo, Wo, Gg^Efm, Gg^Efm, Re^Gvs, Gs^Fds, Gs^Fds, Hh, Gs^Fds, Hh, Hh^Fds, Mm, Mm, Mm, Mm, Mm, Mm, Gs^Fms, Gs^Fmw, Rp, Rp, Gg, Gg, Hh, Rp, Rp, Re^Gvs, Rp, Rr, Re, Gg^Efm, Gs^Fdw, Gs^Fdw, Gs^Fds, Gs^Fdw, Re^Gvs, Gg^Efm, Rp, Rp, Rp, Rp, Gg^Efm, Gg, Rp^Vhc, Gg, Gs^Fp
Wo, Wo, Wo, Wo, Wo, Wo, Wo, Wo, Wwr, Wo, Wo, Ww, Wo, Wo, Wo, Wo, Wo, Ww, Wwr, Wo, Wo, Wo, Wo, Wo, Wo, Wo, Wo, Wo, Gg^Vl, Gg^Efm, Re^Gvs, Re^Gvs, Rp, Rp, Rp, Hh, Hh^Fmf, Mm, Mm, Mm, Mm, Mm, Mm, Hh, Gs^Fmw, Gs^Fmf, Gg^Efm, Rp, Rp, Rp, Re, Rr, Wwf, Wwf, Wo, Re, Re^Gvs, Gg, Gg, Gs^Fdw, Gs^Fdf, Gg, Gg, Gg^Efm, Gg^Efm, Gg^Efm, Rp, Rp, Rp, Gg, Gs^Fp, Gs^Fp
Wo, Wo, Wo, Wo, Wo, Wo, Ww, Wo, Ww, Wo, Ww, Ww, Wo, Wo, Wo, Wo, Wo, Ww, Wwr, Wo, Wo, Wo, Wo, Wo, Wo, Wo, Wwr, Wwf, Rp, Gg^Efm, Gg^Efm, Gg^Efm, Wwf, Wo, Gg^Vl, Hh, Hh^Fdf, Hh^Fmf, Mm, Mm, Mm, Mm, Mm, Hh^Fdf, Hh^Fms, Gs^Fmw, Gg, Gg, Rp, Gg, Re^Gvs, Wwf, Wwf, Wo, Rr, Wo, Wo, Wo, Wo, Gg, Ce, Ce, Gg, Gg, Gg, Rp, Gg^Efm, Gg^Efm, Gg, Gg^Efm, Rp, Gs^Fp
Wo, Wo, Wo, Wo, Wo, Wo, Wo, Ww, Wo, Ww, Wo, Wo, Wo, Wo, Wo, Wo, Ww, Ww, Wo, Wo, Wo, Wo, Wo, Wo, Wo, Wo, Wo, Wo, Wo, Wwf, Wo, Wo, Gg, Wwf, Gs^Fds, Hh, Hh^Fds, Hh^Fmf, Re^Gvs, Rd, Mm, Mm, Mm, Mm, Hh, Hh, Gg, Gg, Rp, Gg, Ch, Ch, Wo, Wwf, Rp, Re^Gvs, Gg, Gg, Gg, Wwf, Wwf, Rp^Vhc, Ce, Re^Gvs, Rp, Rp, Gg^Efm, Gg, Gs^Fds, Gs^Fdf, Gs^Fds, Gs^Fp
Wo, Wo, Wo, Wo, Wo, Wo, Wo, Wo, Wo, Wo, Wwr, Wo, Wo, Wo, Wo, Wo, Wo, Ww, Wo, Wo, Wo, Wo, Ww, Wo, Wo, Wo, Wo, Wo, Wo, Gg, Gs^Fds, Gg^Efm, Hh^Fdw, Hh^Fdf, Re^Gvs, Hh, Hh, Hh^Fds, Rd, Rr, Rr, Mm, Re, Gg^Vl, Rr, Gs^Fmf, Gg, Gg^Efm, Rr, Rp, Re, Gg^Vl, Ch, Wwf, Rp, Gs^Fmf, Gs^Fmf, Gs^Fmw, Gs^Fmw, Rp, Wwf, Ce, Rp, Gg, Rp, Gg, Gg, Gs^Fmw, Gs^Fds, Gs^Fmf, Gs^Fds, Gs^Fp
Wo, Wo, Wo, Wwr, Ww, Ww, Wo, Wo, Wo, Wo, Wo, Wwr, Wwr, Wo, Wo, Wo, Wo, Wo, Wo, Wo, Wo, Ww, Ww, Ww, Wo, Wo, Wo, Wo, Wwr, Gg, Gg^Efm, Hh, Hh, Gs^Fds, Rr, Gg, Rd, Rr, Hh^Fds, Hh^Fmf, Hh^Fds, Rd, Mm, Rr, Mm, Rr, Rr, Rr, Gg, Gg^Efm, Wwf, Ch, Wwf, Wwf, Re^Gvs, Gg^Efm, Gg^Efm, Gs^Fds, Gs^Fmw, Gg, Rp, Wo, Wwf, Gg, Gg, Rp, Gg, Gg, Re^Gvs, Gs^Fmw, Gs^Fds, Gs^Fp
Wo, Wo, Wwr, Wwr, Ww, Ww, Wo, Wo, Wo, Wo, Wo, Wwr, Wwr, Wo, Ww, Wo, Ww, Wwr, Wwr, Wo, Wo, Wo, Ww, Ww, Wo, Wo, Wwr, Wwr, Wo, Gg, Gg, Gs^Fds, Rp, Re, Rp, Gs^Fds, Gg^Vl, Hh, Hh^Fdw, Hh^Fdw, Hh^Fms, Hh, Mm, Mm, Mm, Gs^Fmf, Rr, Gs^Fmf, Wwf, Wwf, Rp, Wwf, Re^Gvs, Re^Gvs, Re^Gvs, Rp, Rp, Gs^Fmw, Gs^Fdw, Rp, Wwf, Wo, Gg, Gs^Fp, Gg, Rp, Gg, Re^Gvs, Rp^Vhc, Rp, Gg, Gs^Fp
Wo, Wo, Wo, Wwr, Ww, Wo, Wo, Wo, Wo, Wo, Ww, Ww, Wwr, Wwr, Wwr, Ww, Wwr, Wwr, Wwr, Wo, Wo, Wo, Wo, Ww, Wo, Wo, Wwr, Ww, Wwr, Wo, Gg, Gg, Re^Gvs, Rp, Re^Gvs, Re^Gvs, Rp, Gs^Fmw, Re^Gvs, Hh^Fdf, Hh^Fds, Hh, Mm, Mm, Mm, Mm, Gg^Vl, Wo, Wwf, Rp, Gs^Fds, Gg, Gs^Fms, Gg, Gg^Vl, Gg, Rp, Gs^Fmf, Gs^Fds, Rp, Rp^Vhc, Wo, Gg, Gg, Re^Gvs, Rp, Rp, Gg^Efm, Gg, Gg, Gg, Gs^Fds
Wo, Wo, Wo, Wwr, Wo, Wo, Wo, Wo, Wwr, Wwr, Wwr, Wwr, Ww, Wwr, Wwr, Wwr, Wwr, Wwr, Wwr, Wwr, Wo, Wo, Wo, Ww, Ww, Wo, Wo, Wwr, Wwr, Wo, Ch, Gg, Gg, Gg, Re^Gvs, Re^Gvs, Rr, Rp, Gg^Efm, Gs^Fmf, Gs^Fmf, Hh^Fds, Mm, Mm, Mm, Mm, Rp, Wwf, Gs^Fmf, Hh, Hh^Fdf, Hh, Hh, Hh, Hh, Gg, Gg, Rp, Rp, Rp, Rr, Ww, Wo, Gg, Gs^Fds, Gg^Efm, Rp, Gg, Gg, Gs^Fp, Gs^Fdf, Gs^Fds
Wo, Wo, Wo, Wo, Wo, Wo, Wo, Wo, Wo, Wwr, Wwr, Wwr, Wwr, Wwr, Ww, Wwr, Wwr, Wwr, Wwr, Wo, Wo, Wo, Wo, Wo, Wo, Wo, Wo, Wo, Wo, Wo, Gg^Vl, Ch, Gg^Efm, Re^Gvs, Hh, Hh, Hh^Fmf, Rr, Rr, Rr, Rp, Hh^Fdw, Mm, Mm, Mm, Rp, Mm, Mm, Hh, Gs^Fmf, Hh, Gs^Fmw, Mm, Mm, Mm, Mm, Hh, Gg, Rp, Rd, Gg, Wwf, Wo, Gg, Gg, Gg^Efm, Rp, Re^Gvs, Gg, Re^Gvs, Rd, Gs^Fp
Wo, Wo, Wo, Wo, Wo, Wo, Wo, Wo, Wo, Wwr, Wwr, Wwr, Ww, Ww, Wo, Ww, Ww, Wwr, Wwr, Wo, Wo, Wo, Wo, Wo, Wo, Wo, Wo, Wo, Wwr, Ch, Ch, Rr, Rr, Rr, Rr, Gs^Fds, Hh^Fds, Hh^Fds, Hh^Fds, Gs^Fmw, Gs^Fmw, Rp, Rp, Mm, Rr, Rr, Rr, Mm, Mm, Gs^Fmw, Mm, Mm, Hh^Fdw, Gs^Fmf, Hh, Hh, Gg, Gg, Ce, Rp, Rp, Gg, Wo, Gg, Re^Gvs, Rp^Vhc, Gg^Efm, Gs^Fdf, Re^Gvs, Rr, Re^Gvs, Gs^Fds
Wo, Wo, Wo, Wwr, Wo, Wo, Wo, Wo, Wwr, Wwr, Wo, Wo, Wo, Wo, Wo, Wo, Wo, Wo, Wo, Wo, Wo, Wo, Wo, Wo, Wo, Wo, Wo, Wwr, Wo, Wwr, Gg, Re^Gvs, Gs^Fdf, Hh, Gs^Fdf, Rr, Hh^Fds, Hh^Fds, Hh^Fmf, Hh, Hh^Fmf, Hh, Mm, Rp, Mm, Mm, Mm, Rr, Rr, Mm, Mm, Hh, Hh, Gs^Fmf, Hh, Gs^Fmf, Gg^Efm, Ce, Rp^Vhc, Re^Gvs, Re^Gvs, Rp, Wwf, Gg, Re^Gvs, Re^Gvs, Gg^Efm, Gs^Fds, Gs^Fds, Gg^Wm, Re^Gvs, Gs^Fds
Wo, Wo, Wo, Wwr, Wo, Wo, Wo, Wwr, Wo, Wo, Wo, Wo, Wo, Wo, Wwr, Ww, Ww, Wo, Wo, Wo, Wo, Wo, Wo, Wo, Wo, Wo, Wwr, Wo, Wo, Gg, Gg^Efm, Hh^Fmf, Hh^Fmf, Hh^Fds, Hh, Rr, Rr, Gs^Fdw, Rr, Hh^Fmf, Hh, Mm, Mm, Mm, Mm, Mm, Mm, Mm, Rr, Mm, Gg^Vl, Mm, Mm, Hh, Hh, Gg^Fet, Gg^Efm, Rd, Ce, Ce, Re^Gvs, Gg, Wwf, Gg, Re^Gvs, Gg, Rp, Gg, Gg^Fet, Gs^Fmf, Gs^Fp, Gs^Fds
Wo, Wo, Wo, Wwr, Wo, Wo, Wo, Wo, Wo, Wo, Wo, Wo, Wo, Wwr, Wo, Wwr, Wwr, Wo, Wo, Wo, Wo, Wo, Wo, Wo, Wwr, Wwr, Wo, Wo, Gg^Efm, Gg, Hh, Hh^Fmf, Gs^Fds, Gs^Fdf, Gg, Gg^Efm, Gg^Vl, Rr, Hh, Rr, Rr, Mm, Hh, Mm, Gg^Vl, Mm, Mm, Mm, Mm, Rr, Rr, Rr, Rr, Gs^Fmf, Hh, Gs^Fmf, Gs^Fds, Re^Gvs, Gg, Re^Gvs, Gg, Gg^Efm, Wo, Rp, Rp, Rd, Rp, Gs^Fmf, Gs^Fdw, Gs^Fds, Gs^Fp, Gs^Fp
Wo, Wo, Wo, Wwr, Wwr, Wo, Wo, Wo, Wo, Wo, Wo, Wo, Wo, Wo, Wo, Wo, Wo, Wo, Wo, Wo, Wo, Wo, Wo, Wo, Wwr, Wwf, Gg^Vl, Gg, Re^Gvs, Gs^Fds, Gs^Fp, Gs^Fdf, Gg^Efm, Gg^Efm, Wo, Wwf, Wo, Wwf, Hh, Mm, Mm, Rr, Hh^Fdw, Mm, Rp, Wwf, Hh^Fdw, Mm, Mm, Mm, Mm, Mm, Rr, Hh, Mm, Gs^Fmf, Gs^Fmf, Gs^Fds, Gs^Fmf, Gg, Gs^Fdw, Gg^Efm, Wo, Gg, Gg, Rp, Rp, Gs^Fds, Gs^Fdw, Gs^Fp, Gs^Fdf, Gs^Fds
Wo, Wo, Wo, Wo, Wwr, Wwr, Wo, Wo, Wo, Wo, Wo, Wo, Wo, Wo, Wo, Wo, Wo, Wo, Wo, Wo, Wo, Wo, Wwr, Wwr, Wwr, Wo, Gg, Re^Gvs, Gg^Efm, Re, Gg, Gg, Wo, Wo, Rp, Wwf, Hh, Gg, Hh^Fdf, Mm, Rr, Rr, Rr, Hh^Fdw, Wwf, Wwf, Hh, Mm, Mm, Mm, Mm, Mm, Rr, Mm, Hh, Mm, Hh, Gg^Fet, Gs^Fdw, Gs^Fdw, Gs^Fds, Gg^Efm, Gg, Wo, Gg, Gg^Efm, Rp, Gg^Efm, Ce, Ce, Gs^Fds, Gs^Fdf
Wo, Wo, Wo, Wo, Wo, Wo, Wo, Wo, Wo, Wo, Wwr, Wo, Wo, Wo, Wo, Wo, Wo, Wo, Wo, Wwr, Wwr, Wo, Wwr, Wwr, Gg, Wo, Wo, Gg, Wo, Gg, Wwf, Wwf, Wo, Wwf, Hh, Hh, Gs^Fmw, Gs^Fmw, Hh^Fdf, Hh, Gg^Vl, Gs^Fmf, Gs^Fdw, Rr, Wo, Rr, Hh, Mm, Mm, Mm, Mm, Mm, Rr, Hh^Fdf, Hh^Fdf, Hh, Hh, Hh, Hh, Hh, Gs^Fdw, Gs^Fdw, Gg, Wo, Gg^Efm, Gg, Gg^Efm, Rp, Gg^Efm, Rp^Vhc, Ce, Gs^Fds
Wo, Wo, Wo, Wo, Wo, Wo, Wo, Wo, Wo, Wo, Wo, Wo, Wo, Wwr, Wwr, Wo, Wwr, Wo, Wo, Wo, Gg, Wo, Gg, Gg^Efm, Gg^Efm, Wo, Rp, Wo, Gg, Wo, Gg^Efm, Ce, Gg^Vl, Ce, Hh, Hh, Hh, Hh^Fdf, Hh^Fdw, Hh, Hh, Rr, Rr, Rr, Wwf, Rr, Rr, Hh, Hh, Mm, Hh, Rp^Vhc, Rr, Rp, Rp, Rd, Rp, Rd, Rp^Vhc, Hh, Rp, Gs^Fdw, Rp, Wwf, Wo, Gg, Gs^Fp, Rp, Rp, Ce, Gg^Efm, Gs^Fds
Wo, Wo, Wo, Wo, Wo, Wo, Wo, Wo, Wo, Wo, Wo, Wo, Wwr, Wwr, Gg, Wo, Ch, Wo, Ch, Gg, Gg, Rd, Rd, Gs^Fdw, Hh^Fdw, Gg, Gg^Vl, Rp, Re, Gg, Gs^Fds, Ce, Hh, Ce, Re, Re, Re, Gs^Fmf, Gs^Fmf, Gs^Fmf, Hh, Hh, Rr, Rr, Wo, Wwf, Hh, Hh, Mm, Mm, Rd, Rr, Gs^Fmf, Rd, Rd, Rp, Gs^Fds, Rp, Hh, Rp, Gs^Fdf, Rp, Gg, Gg^Efm, Wo, Gg, Gs^Fdf, Gg^Efm, Rp, Gg^Efm, Gg^Efm, Gg
Wo, Wo, Wo, Wo, Wo, Wo, Wo, Wo, Wo, Wo, Wo, Wwr, Gg, Gg, Gg, Rp, Ch, Gg^Vl, Ch, Gs^Fds, Hh^Fdw, Hh^Fds, Hh^Fds, Rd, Hh^Fdf, Hh^Fdf, Hh^Fdw, Hh, Hh^Fdf, Re, Gs^Fds, Hh, Hh^Fdw, Gs^Fds, Gs^Fmw, Gs^Fds, Re, Gs^Fmf, Gs^Fdw, Hh, Gg, Gg, Rr, Wo, Wwf, Rr, Gs^Fdf, Gs^Fmf, Hh, Hh, Hh^Fdw, Rr, Gs^Fmf, Gs^Fmf, Hh^Fdf, Gs^Fds, Hh^Fdw, Gs^Fds, Hh^Fdf, Hh^Fmf, Hh, Gg^Efm, Re^Gvs, Gg, Wo, Gg, Gg^Efm, Gs^Fds, Gg, Rp, Rp, Gg
Wo, Wo, Wo, Wo, Wo, Wo, Wo, Wo, Wo, Wo, Wo, Wwr, Gg, Rd, Re^Gvs, Re^Gvs, Gs^Fdf, Re, Hh, Gs^Fds, Hh, Gs^Fds, Gs^Fdf, Rd, Rd, Hh^Fdw, Hh^Fdf, Gs^Fds, Rd, Re, Rd, Hh^Fdf, Gs^Fds, Gs^Fmw, Hh, Hh, Gg^Vl, Re^Gvs, Hh^Fdf, Gg, Wwf, Wwf, Wwf, Wwf, Gg^Vl, Rd, Gs^Fdf, Gs^Fds, Rr, Gs^Fmw, Rr, Rr, Hh, Gs^Fds, Gs^Fdw, Hh, Hh^Fdf, Hh^Fp, Rd, Rd, Rd, Gg^Efm, Gg, Rp^Vhc, Wo, Gg, Gs^Fp, Rr, Rp^Vhc, Gg, Rp, Gg^Efm
Wo, Wo, Wo, Wo, Wwr, Wo, Wo, Wo, Wo, Wo, Wo, Wo, Gg^Vl, Rd, Re, Gs^Fds, Gs^Fdf, Gs^Fdf, Hh^Fdw, Hh^Fdf, Hh, Gs^Fdf, Gg^Efm, Gg, Rd, Gg, Gg, Gs^Fp, Hh^Fdf, Hh^Fds, Hh, Re, Hh^Fds, Hh, Hh, Hh, Gs^Fdw, Rp, Rp, Wwf, Wo, Wo, Wwf, Wwf, Rr, Gs^Fds, Rr, Rr, Mm, Rr, Wwf, Rr, Ch, Re, Ch, Gs^Fp, Re, Rd, Hh^Fdf, Gs^Fmf, Hh, Gs^Fds, Gg^Efm, Wo, Gg^Efm, Gg, Gs^Fp, Gs^Fp, Gg, Gg, Rp, Gg^Efm
Wo, Wo, Wwr, Wwr, Wwr, Wwr, Wwr, Wwr, Gg, Gg, Gg^Fet, Gg, Rp, Re, Gs^Fds, Re, Re, Hh^Fdw, Gs^Fmf, Gs^Fmf, Rp, Gg^Efm, Wwf, Rp, Wwf, Gg, Gg, Gg, Gg, Gg, Gg, Re, Gs^Fdw, Gs^Fdw, Gg, Gs^Fdw, Gg, Gg, Ww, Wwf, Gg^Efm, Gg, Gg, Wwf, Wwf, Wwf, Wwf, Mm, Wwf, Wwf, Wo, Rp, Ch, Rp^Vhc, Ch, Re, Re^Gvs, Gs^Fdf, Hh, Hh, Gs^Fmw, Gg^Efm, Gg, Wo, Gg, Gg, Gs^Fds, Gs^Fp, Re^Gvs, Gg^Efm, Rp, Gg
Wo, Wo, Wo, Wwr, Wo, Wo, Gg, Gg, Re^Gvs, Rd, Re^Gvs, Gs^Fds, Gs^Fp, Hh, Gs^Fp, Hh, Re, Gs^Fds, Gg, Gs^Fds, Rp, Wwf, Ch, Wo, Ch, Wwf, Wo, Rp, Wo, Gg^Efm, Wwf, Gg^Vl, Wo, Gg, Wo, Gg, Wwf, Wo, Gg, Gg, Gs^Fdw, Re^Gvs, Gs^Fmf, Hh, Mm, Mm, Mm, Wwf, Gs^Fmw, Gg, Gg, Wo, Wwf, Wo, Wwf, Gg, Gg, Gs^Fdw, Gs^Fdw, Hh, Gg, Gg, Wo, Wo, Gg, Gs^Fdw, Gg^Efm, Gs^Fds, Rp, Rp, Gg, Gg
Wo, Wo, Wo, Wo, Wo, Gg^Vl, Wo, Rd, Rd, Gg^Fet, Gs^Fp, Ch, Gg^Vl, Ch, Gg^Fet, Gs^Fp, Gg^Efm, Re, Gg, Rp, Wo, Wwf, Ch, Gg^Vl, Ch, Wwf, Wwf, Wo, Gg, Wwf, Gg, Wo, Gg, Wo, Gg, Wwf, Gg, Gg^Efm, Rp, Gs^Fmf, Hh, Hh, Mm, Mm, Mm, Mm, Mm, Hh, Gs^Fmf, Gs^Fds, Gs^Fp, Gg, Gg^Efm, Gg, Gg^Efm, Wo, Gg, Gs^Fmf, Hh, Gs^Fds, Gg, Wwf, Gg^Efm, Gg, Gs^Fdf, Gg^Efm, Gg^Efm, Rp, Gg^Efm, Gg, Rp, Wo
Wo, Wo, Wwr, Wwr, Wo, Wo, Wwr, Wwr, Wwf, Gg^Efm, Gg, Ch, Wo, Ch, Gs^Fds, Gg, Wwf, Wwf, Rp, Wwf, Wwf, Gg, Gg^Efm, Gg, Rr, Rr, Hh, Gg^Fet, Hh, Gg^Efm, Hh, Gg, Hh^Fdf, Gg^Efm, Hh^Fdf, Gg, Re, Re^Gvs, Rp, Re, Gs^Fmf, Hh, Hh, Mm, Mm, Mm, Mm, Hh, Gs^Fdw, Hh, Hh, Gs^Fds, Gg^Efm, Re^Gvs, Rr, Wo, Wo, Gg, Hh, Gg, Wo, Wo, Rr, Gg, Rp, Rp, Rp, Ch, Rp^Vhc, Ch, Wwf, Wo
Wo, Wwr, Wo, Gg, Wo, Wo, Gg, Wwr, Gg, Gg, Wwf, Rp, Wo, Wwf, Rp, Gg, Gg, Wo, Wwf, Wo, Wo, Gg, Re^Gvs, Rr, Re, Hh, Gs^Fds, Gs^Fmf, Rd, Hh, Gs^Fds, Hh, Hh, Hh, Hh, Hh, Hh, Gg^Vl, Rr, Hh, Hh^Fdw, Gs^Fds, Hh^Fdf, Hh, Rr, Gs^Fds, Hh, Hh, Rd, Gs^Fds, Gs^Fp, Hh, Hh, Gs^Fp, Rr, Wwf, Wo, Gg, Gs^Fmf, Gg^Efm, Wo, Rp^Vhc, Rp, Rp, Gs^Fdw, Gg, Gg^Efm, Ch, Wo, Ch, Wwf, Rp
Wo, Wo, Wo, Wo, Wwr, Wo, Wo, Gg, Wo, Wo, Wo, Wwf, Rp, Gg, Rp, Rd, Gg^Vl, Gg^Efm, Wwr, Ww, Gg, Rr, Re^Gvs, Rr, Rr, Rr, Rr, Gg^Vl, Rr, Hh^Fdw, Gs^Fdw, Gs^Fds, Gs^Fmf, Hh, Rr, Gs^Fmw, Rr, Rr, Gs^Fds, Hh, Hh, Hh^Fdw, Hh^Fdw, Rr, Hh, Rr, Rr, Gg^Vl, Rr, Re^Gvs, Re^Gvs, Gs^Fp, Gs^Fds, Gs^Fds, Gg^Vl, Wo, Wwf, Gg^Efm, Gg^Efm, Gg^Efm, Wo, Gg, Rd, Gs^Fds, Gg, Gg, Wwf, Wwf, Wwf, Wwf, Gs^Fdf, Gs^Fp
Wo, Wo, Wo, Wwr, Wo, Wwr, Wwr, Wo, Gg^Vl, Rp, Re^Gvs, Rp, Re^Gvs, Gg, Gg, Rp, Ww, Wwf, Wo, Wwr, Gg, Gg^Vl, Gg, Gs^Fdw, Rr, Rd, Hh^Fmf, Rr, Gs^Fds, Rr, Rr, Gs^Fmw, Rr, Rr, Hh, Rr, Gs^Fmw, Re, Re, Hh^Fdf, Re^Gvs, Hh^Fdf, Rr, Rr, Hh^Fp, Gs^Fmf, Gs^Fmf, Rr, Gs^Fds, Gg, Re^Gvs, Gs^Fds, Gg^Fet, Gs^Fds, Rr, Rp, Wo, Gg, Gs^Fdw, Gg, Wo, Gg, Gg, Gg, Wo, Wwf, Gg^Efm, Rp, Gg, Rp, Gs^Fp, Gs^Fds
Wo, Wo, Wo, Wo, Wo, Wo, Wo, Wo, Wwf, Gg, Wwf, Gg, Wo, Wo, Wo, Wo, Wo, Wo, Wo, Wwr, Wo, Gg, Wwr, Gg^Efm, Gg, Gs^Fds, Gs^Fds, Gs^Fdw, Rr, Rr, Ce, Rr, Rr, Hh, Hh, Hh, Hh, Hh, Hh^Fdf, Re, Rp, Gg^Vl, Rr, Gs^Fds, Hh^Fdf, Gs^Fds, Hh, Hh, Gs^Fdw, Gs^Fdw, Gs^Fdw, Re^Gvs, Re^Gvs, Re^Gvs, Gg, Gg, Wo, Gg, Gg, Gg, Wo, Gg, Wo, Wo, Gg^Efm, Gg^Efm, Rp^Vhc, Gg, Rp, Gg^Efm, Gs^Fdw, Gs^Fp
Wo, Wo, Wo, Wo, Wo, Wo, Wo, Wo, Wwr, Wwr, Wwr, Wo, Wo, Wwr, Wo, Gg, Wwr, Wo, Wo, Wwr, Wo, Wo, Wo, Wwr, Gg, Gg, Gg, Rr, Wwf, Ww, Wwf^Vht, Ce, Rp, Gg, Hh^Fdf, Hh, Gg, Gs^Fdw, Rp, Rp, Hh, Rr, Hh^Fp, Rp, Rp, Hh^Fp, Hh^Fp, Hh, Gs^Fdw, Gs^Fds, Re^Gvs, Re^Gvs, Gg^Wm, Gg, Gg, Wwf, Wo, Gg, Wo, Wo, Gg^Efm, Wwf, Gg^Efm, Gg^Efm, Gs^Fds, Rd, Re^Gvs, Gg, Rp, Gg^Efm, Gs^Fds, Gs^Fdw
Wo, Wo, Wo, Wo, Wo, Wo, Wo, Wo, Wo, Wo, Wo, Wo, Wo, Wo, Wwr, Wwr, Wwr, Wo, Wo, Wo, Wwr, Wo, Wo, Wo, Wo, Wo, Wo, Wo, Rr, Ce, Ce, Wo, Wwf, Gg^Efm, Gg, Hh, Gg, Rp, Gg, Gs^Fmf, Gs^Fmf, Hh, Hh, Hh^Fp, Rp, Hh^Fp, Gs^Fds, Hh, Gg^Efm, Re^Gvs, Gg^Efm, Re^Gvs, Gg, Gg, Wwr, Wwf, Wo, Wwf, Wwf, Rp^Vhc, Re^Gvs, Gg^Efm, Rp, Gg, Gg^Efm, Gs^Fdf, Gs^Fds, Gg^Efm, Rp, Gg, Gs^Fp, Gs^Fdw
Wo, Wo, Wo, Wo, Wwr, Wo, Wo, Wo, Wo, Wo, Wo, Wo, Wo, Wo, Wo, Wo, Wo, Wo, Wo, Wo, Wwr, Wwr, Gg, Gg, Gg, Wo, Gg, Gg, Gs^Fdf, Gg, Gll^Fdf, Gll^Fdf, Wo, Wo, Wo, Gg^Efm, Gg^Efm, Re^Gvs, Re^Gvs, Gs^Fp, Gs^Fp, Hh, Re^Gvs, Rp, Rd, Gs^Fds, Gg^Efm, Gg^Efm, Gg, Gg^Efm, Gg, Ch, Gg^Vl, Ch, Wwr, Ww, Wo, Wwf, Gg, Gg^Efm, Gs^Fds, Gg, Re^Gvs, Rp, Gg, Gs^Fdw, Gg^Efm, Rp, Gg, Gg, Re^Gvs, Gs^Fds
Wo, Wo, Wo, Wo, Wo, Wo, Wwr, Ww, Wwr, Ww, Wo, Wo, Wo, Wo, Wo, Wo, Wo, Wo, Wo, Wwr, Wwr, Wwf, Gg^Vl, Gg^Efm, Gg^Efm, Rd, Gg^Efm, Gs^Fds, Gg, Gg, Gg, Gll^Fdf, Wo, Wo, Wwr, Wwr, Gg, Gg^Efm, Gg^Efm, Hh^Fdf, Re^Gvs, Gg^Efm, Rd, Rp, Rd, Gg^Vl, Wo, Wwr, Wo, Gg, Gg, Ch, Ww, Ch, Wwr, Wo, Wo, Wwf, Rp, Gg, Gs^Fdf, Gs^Fdw, Re^Gvs, Rp, Rp, Gg^Efm, Rp, Rp, Gg, Rp^Vhc, Rp, Gs^Fdw
Wo, Wo, Wo, Wwr, Wwr, Wwr, Wo, Wwr, Wo, Wwr, Wo, Wo, Wo, Wo, Wo, Wo, Wo, Wo, Wo, Wo, Wo, Ww, Wo, Gg, Wwr, Gg, Wwr, Gg, Wwr, Gg, Wo, Gll^Fdf, Wo, Wo, Wwr, Wwr, Wwr, Gg, Wwf, Gg^Vl, Gg, Rd, Rp, Rp, Wo, Wo, Wo, Wwr, Wwr, Wo, Wo, Wwr, Wo, Wo, Wo, Wo, Ww, Wwf, Wwf, Re, Ce, Gs^Fp, Gg, Gg^Efm, Rp, Rp, Rp, Gg^Efm, Rp, Gg, Gg, Gs^Fds
Wo, Wo, Wo, Wwr, Wo, Wo, Wo, Wo, Wwr, Wo, Wo, Wo, Wo, Wo, Wo, Wo, Wo, Wo, Wo, Wo, Wo, Wo, Wo, Wo, Wwr, Wo, Wo, Wo, Wo, Wo, Wo, Wo, Wo, Wo, Wwr, Wo, Wo, Wwr, Wo, Ww, Wo, Rp, Wwr, Wwf, Wwr, Wwr, Wo, Wo, Wo, Wo, Wo, Wo, Wo, Wo, Wwr, Ww, Gg^Efm, Wo, Wwf, Wo, Rp^Vhc, Ce, Rp, Rp, Gg, Re^Gvs, Re^Gvs, Rp, Gg^Efm, Rp, Rp, Gg
Wo, Wo, Wo, Wo, Wo, Wo, Wo, Wwr, Wwr, Wwr, Wwr, Wwr, Wwr, Wo, Wo, Wo, Wo, Wo, Wo, Wo, Wo, Wo, Wo, Wwr, Wo, Wo, Wo, Wo, Wo, Wo, Wo, Wo, Wo, Wo, Wo, Wo, Wo, Wo, Wo, Wo, Wwr, Wwr, Wo, Wwr, Wwr, Wo, Wo, Wo, Wo, Wo, Wo, Wwr, Wwr, Wo, Wo, Gg^Efm, Gg^Efm, Rp, Wwf, Ce, Ce, Rp, Gg^Efm, Gg^Efm, Gs^Fp, Gg^Efm, Gs^Fp, Gg^Efm, Gs^Fdw, Gg, Gg, Rp
Wo, Wo, Wo, Wo, Wwr, Wo, Ww, Ww, Ww, Wwr, Ww, Wwr, Ww, Wwr, Wwr, Wo, Wo, Wo, Wo, Wo, Wo, Wo, Wo, Wo, Wo, Wo, Wo, Wo, Wo, Wo, Wo, Wo, Wo, Wo, Wo, Wo, Wo, Wo, Wo, Wwr, Wo, Wo, Wo, Wwr, Wo, Wo, Wo, Wo, Wwr, Ww, Rp^Vhc, Wwf, Wo, Wo, Gg^Efm, Gg^Efm, Gg^Efm, Rp, Re^Gvs, Rp, Rp, Gg^Efm, Gg, Gg^Efm, Ce, Ce, Rd, Gs^Fp, Gs^Fdw, Gs^Fdw, Gs^Fdf, Gg
Wo, Wo, Wo, Wo, Wo, Wwr, Wwr, Wo, Wo, Ww, Ww, Ww, Wo, Ww, Ww, Wwr, Wo, Wo, Wo, Wo, Wo, Wo, Wo, Wo, Wo, Wo, Wo, Wo, Wwr, Wo, Wo, Wo, Wo, Wo, Wo, Wo, Wo, Wo, Wo, Wo, Wo, Wo, Wo, Wwr, Wo, Wo, Gg, Gg, Gg, Gg, Gg, Gs^Fdw, Gs^Fds, Gg^Efm, Gg^Efm, Gg^Efm, Gg^Efm, Re^Gvs, Gg^Efm, Re^Gvs, Gg^Wm, Rp, Rp, Gg, Gg, Rp^Vhc, Ce, Gg, Gs^Fdw, Gs^Fp, Gs^Fp, Gs^Fdf
Wo, Wo, Wo, Wo, Wo, Wo, Wo, Wwr, Wo, Wo, Wo, Wo, Wo, Wwr, Wo, Ww, Wo, Wo, Wo, Wo, Wo, Wo, Ww, Wo, Wwr, Wo, Wo, Wwr, Wwr, Wo, Ww, Wo, Wwr, Wo, Wo, Wo, Wo, Wo, Wo, Wo, Wo, Wo, Wo, Wo, Gg, Gg, Gg, Gs^Fdw, Gg^Efm, Gs^Fds, Gs^Fms, Gs^Fp, Rp, Rp, Ce, Rp, Ce, Gg, Gs^Fdw, Re^Gvs, Gg, Gg^Efm, Rp, Rp, Rp, Ce, Gg^Efm, Gg^Efm, Gg, Gs^Fdf, Gs^Fp, Gs^Fdf
Wo, Wo^Xo, Wo^Xo, Wo, Wo, Wo, Wo, Wo, Wo, Wo, Wo, Wo, Wo, Wo, Wo, Wo, Wo, Wo, Wo, Wo, Wwr, Ww, Wwr, Wwr, Wo, Wo, Wwr, Wwr, Wwr, Wwr, Wwr, Wwr, Ww, Wo, Wo, Wo, Wo, Wwr, Wo, Wo, Wwr, Ce, Rp^Vhc, Ce, Gg, Gg, Rp, Rp, Re^Gvs, Rp, Rp, Gg^Efm, Rp, Gg^Efm, Ce, Rp^Vhc, Ce, Gg^Efm, Gs^Fdw, Gs^Fdw, Gs^Fmf, Gg^Efm, Gg^Efm, Gg^Efm, Gg^Efm, Rp, Rp, Gg^Efm, Gg, Gs^Fp, Rd, Gs^Fdw
Wo, 1 Wo, 3 Wo, Wo^Xo, Wo^Xo, Wo, Wo, Wo, Wo, Wo, Wo, Wo, Ww, Wo, Ww, Wo, Ww, Ww, Wo, Wo, Wo, Wwr, Wwr, Wwr, Wo, Wo, Wo, Wo, Ww, Ww, Ww, Ww, Wo, Wo, Wo, Wo, Wo, Wo, Wwr, Wwr, Rr, Ce, Gg^Efm, Ce, Gg^Efm, Re^Gvs, Gg^Efm, Gg^Efm, Gg^Efm, Gg^Efm, Gg, Rp, Rp, Gg, Gg^Efm, Gg, Gs^Fmf, Gs^Fp, Gs^Fp, Gs^Fmf, Rd, Gg^Efm, Re^Gvs, Gs^Fds, Re^Gvs, Gg, Rp, Rp, Gg, Re^Gvs, Re^Gvs, Gs^Fp
Wo, 2 Wo, 4 Wo, 5 Wo, 6 Wo, 8 Wo^Xo, 9 Wo^Xo, 10 Wo, 11 Wo, Wo, Wo, Wo, Wo, Ww, Wo, Ww, Wo, Wo, Wo, Wo, Wo, Wo, Wo, Wo, Wo, Wo, Wo, Wo, Wo, Wo, Wo, Wo, Wo, Wo, Wo, Wo, Wo, Wo, Wwr, Wwf, Rr, Rd, Gs^Fp, Gg^Efm, Gs^Fdw, Gg^Efm, Gs^Fds, Gs^Fp, Rd, Rp^Vhc, Rd, Gg^Efm, Gs^Fp, Rp, Gs^Fp, Gs^Fp, Rd, Re^Gvs, Rd, Gs^Fdw, Gs^Fms, Rp^Vhc, Gs^Fmf, Gs^Fmf, Gs^Fms, Gg, Gg, Rp, Rd, Rp^Vhc, Rd, Gs^Fmf
Wo, Wo, Wo, Wo, Wo, Wo, Wo, Wo, Wo, Wo, Wo, Wo, Wo, Wo, Wo, Wo, Wo, Wo, Wo, Wo, Wo, Wo, Wo, Wo, Wo, Wo, Wo, Wo, Wo, Wo, Wo, Wo, Wo, Wo, Wo, Wo, Wo, Wo, Wo, Wwf, Gs^Fp, Gs^Fds, Gs^Fds, Gs^Fp, Gs^Fdw, Gs^Fdw, Gs^Fms, Gs^Fdf, Gs^Fdf, Gs^Fdf, Gs^Fdf, Gs^Fdf, Gs^Fdf, Gs^Fp, Gs^Fms, Gs^Fms, Gs^Fms, Rd, Gs^Fmf, Gs^Fmf, Gs^Fmf, Gs^Fmf, Gs^Fmf, Gs^Fmf, Gs^Fdf, Gs^Fms, Gs^Fmw, Gs^Fmw, Gs^Fmf, Gs^Fmf, Gs^Fmf, Gs^Fmf
