Ai, Aa, Aa^Fpa, Rr, Aa, Aa, Ha, Aa, Ha, Mm, Mm, Mm, Mm, Mm, Mm, Mm, Mm^Xm, Mm^Xm, Mm, Mm, Mm, Mm, Mm, Mm, Mm, Mm, Mm, Mm, Mm, Mm, Mm, Mm, Mm, Mm^Xm, Mm, Ha, Ha, Ha, Ha, Ha, Ha, Ha, Ha, Aa, Aa, Aa, Re, Aa, Aa^Fpa, Aa^Fpa, Aa^Fpa, Aa^Fpa, Aa^Fpa
Wo, Ai, Ha, Rr, Aa^Fpa, Ha, Gs^Fp, Aa, Hh, Mm, Hh, Mm, Mm, Mm, Re^Gvs, Mm, Mm, Mm^Xm, Mm, Mm, Gg, Aa^Fpa, Ha, Ha, Ha, Aa^Fpa, Aa, Ha, Mm, Ha, Gg^Vh, Mm, Mm^Xm, Mm^Xm, Mm, Mm^Xm, Mm, Ha, Mm, Ha, Mm, Ha, Mm, Ha, Ha, Aa, Re, Ha^Fma, Aa, Aa^Fpa, Aa^Fpa, Aa^Fpa, Aa^Fpa
Wo, Wo, Ds, Rr, Rr, Gg, Gg^Vc, Re^Gvs, Re^Gvs, Hh, Gs^Fp, Gg^Vc, Hh, Re^Gvs, Hh, Hh, Hh, Mm^Xm, Mm, Gg^Vh, Ha, Aa, Ai, Ai, Ai, Aa, Ai, Ai, Ai, Gg, Aa, Mm, Mm, Mm, Mm, Mm^Xm, Mm^Xm, Mm, Mm^Xm, Mm, Mm, Mm, Mm, Mm, Ha, Gg^Ve, Aa^Fpa, Re, Re, Aa^Fpa, Aa^Fpa, Aa^Fpa, Aa^Fpa
Wo, Wo, Ds, Gg, Rr, Gg, Gg, Re^Gvs, Hh, Gg, Rr, Rr, Rr, Re^Gvs, Rr, Hh, Re^Gvs, Mm^Xm, Mm^Xm, Mm, Aa, Ai, Ai, Ai, Ww, Ai, Ww, Wo, Wo, Ai, Ha, Aa^Fpa, Ha, Mm, Mm, Mm, Mm, Mm^Xm, Mm^Xm, Mm^Xm, Mm^Xm, Mm^Xm, Mm, Mm, Mm, Ha, Ha, Aa^Fpa, Re, Aa, Aa^Fpa, Ha, Aa^Fpa
Wo, Wo, Wo, Hh, Hh, Rr, Hh, Hh, Re^Gvs, Rr, Hh, Hh, Gs^Fp, Rr, Gg^Vc, Re^Gvs, Mm, Mm, Mm^Xm, Aa^Fpa, Aa, Ai, Ai, Wo, Wo, Ww, Gg^Vh, Ww, Ww, Aa, Ha, Aa, Ha, Ha, Ha, Mm, Mm, Mm^Xm, Mm, Mm^Xm, Mm, Mm^Xm, Mm^Xm, Mm, Mm^Xm, Mm, Mm, Ha, Re, Gg^Ve, Ha, Aa^Fpa, Aa^Fpa
Wo, Wo, Wo, Wo, Gg^Vc, Rr, Hh, Gg, Re^Gvs, Gg^Vc, Gg, Hh, Re^Gvs, Gg, Hh, Mm, Mm, Mm^Xm, Mm^Xm, Aa, Mm, Ai, Ai, Ai, Wo, Ww, Ha, Gg, Ww, Aa, Ww, Ww, Wo, Aa^Fpa, Gg^Vh, Ha, Mm, Mm, Mm, Mm, Mm, Mm, Mm, Mm^Xm, Mm^Xm, Mm^Xm, Mm, Ha, Ha, Re, Aa, Aa^Fpa, Gs^Fp
Wo, Wo, Wo, Ds, Ds, Rr, Gg, Hh, Gs^Fp, Re^Gvs, Gg, Hh, Re^Gvs, Gg, Hh, Mm, Hh, Mm, Mm, Mm^Xm, Mm, Aa^Fpa, Ha, Ai, Ai, Wo, Ww, Ww^Bw|, Ww, Ww, Aa, Ha, Mm, Wo, Wo, Gg, Hh, Mm, Hh, Mm, Mm, Mm, Hh, Mm, Mm, Mm^Xm, Mm, Ha, Hh, Re, Gg, Hh, Gs^Fp
Wo, Wo, Wo, Wo, Hh, Rr, Rr, Gg, Hh, Hh, Gg, Re^Gvs, Gg, Gg, Gs^Fp, Gg, Hh, Gs^Fp, Gs^Fp, Mm^Xm, Mm^Xm, Mm, Ha, Mm, Xu, Xu, Uu^Ii, Ur^Ii, Tb^Tf, Xu, Xu, Mm, Mm, Ai, Wo, Hh, Gs^Fp, Gs^Fp, Hh, Gg^Vh, Gg, Hh, Mm, Mm, Mm, Mm^Xm, Mm, Mm, Hh, Re, Gs^Fp, Gs^Fp, Gs^Fp
Wo, Wo, Wo, Wo, Wo, Gg, Rr, Gg, Gs^Fp, Gg, Gs^Fp, Gs^Fp, Gg, Gs^Fp, Gs^Fp, Gs^Fp, Gs^Fp, Gs^Fp, Gs^Fp, Mm, Mm, Mm^Xm, Mm^Xm, Mm, Xu, Uu^Vu, Ur, Ur, Ur, Uu^Vu, Xu, Mm, Mm, Ha, Gg^Efm, Wo, Ww, Gg^Efm, Ww, Hh, Wo, Gg^Efm, Gs^Fp, Hh, Hh, Mm, Hh, Hh, Re, Re, Gg^Ve, Gs^Fp, Gs^Fp
Wo, Wo, Wo, Wo, Wo, Ds, Rr, Gg, Gg, Gg, Gs^Fp, Gg^Fet, Gs^Fp, Gg^Fet, Gg^Ve, Gs^Fp, Gs^Fp, Gs^Fp, Hh, Gs^Fp, Hh, Mm, Mm, Xu, Uh^Ii, Ur, Uh, Uh, Ur, Uh, Xu, Mm, Mm, Mm, Mm, Hh, Gs^Fp, Ww, Gs^Fp, Wo, Gg^Efm, Wo, Gg, Gs^Fp, Hh, Hh, Gs, Hh, Re, Gs^Fp, Gg, Gg^Fet, Gs^Fp
Wo, Wo, Wo, Wo, Wo, Ds, Gg, Rr, Rr, Gg, Gs^Fp, Hh, Gs^Fp, Gs^Fp, Gg, Gg, Gs^Fp, Gg^Fet, Gg^Ve, Gs^Fp, Gg, Hh, Gs^Fp, Mm, Uu^Ii, Ur, Ur, Uh, Ur, Uh, Xu, Mm, Hh, Mm, Mm, Mm, Mm, Gs^Fp, Mm, Hh, Gs^Fp, Wo, Wo, Gg^Efm, Gg, Gs^Fp, Ww, Gs^Fp, Re, Gs^Fp, Gs^Fp, Gs^Fp, Gs^Fp
Wo, Wo, Wo, Wo, Wo, Wo, Gg^Vh, Re^Gvs, Re^Gvs, Rr, Gs^Fp, Gs^Fp, Gg^Fet, Gs^Fp, Gs^Fp, Gs^Fp, Gs^Fp, Gg, Gs^Fp, Gs^Fp, Gg, Gs^Fp, Gs^Fp, Re, Ur^Ii, Ur, Xu, Uu^Vu, Xu, Xu, Mm, Mm, Gg, Hh, Hh, Hh, Hh, Mm, Hh, Gg^Vh, Hh, Gg, Gs^Fp, Wo, Gs^Fp, Wo, Re, Ww^Bw/, Hh, Re, Gg^Ve, Gg, Gs^Fp
Wo, Wo, Wo, Wo, Wo, Wo, Re, Re^Gvs, Rp, Rp, Re^Gvs, Gs^Fp, Gs^Fp, Gg, Gg, Gs^Fp, Gg, Hh, Gg, Gg, Gg, Gg, Re, Re, Mm, Xu, Mm, Xu, Mm, Mm, Hh, Hh, Gg, Gg, Gg, Gg, Gg, Gs^Fp, Hh, Gg, Gg^Efm, Gg, Gg, Wo, Wo, Wo, Re, Ww, Wo, Gg, Gs^Fp, Gs^Fp, Gs^Fp
Wo, Wo, Wo, Wo, Wo, Ds, Ds, Rp, Gg, Re^Gvs, Re^Gvs, Gg, Gg, Gs^Fp, Gg, Gg, Re, Re, Re, Re, Re, Re, Gg, Gg, Gg, Mm, Hh, Mm, Hh, Hh, Gg, Gg, Ss, Gg, Ds, Gg, Ss, Hh, Hh, Hh, Hh, Hh, Hh, Gg^Efm, Gs^Fp, Gg, Re, Hh, Gg, Wo, Wo, Gs^Fp, Wo
Wo, Wo, Wo, Wo, Ww, Wo, Ww, Ww^Bw|, Ww, Gg^Vh, Ss, Re, Re, Gg, Re, Re, Gg, Gg, Gg, Gg, Gg, Re, Re, Gs^Fp, Gs^Fp, Gg, Gg, Hh, Gg, Gg, Ss, Gs^Fp, Ss, Gg^Vh, Ss, Gs^Fp, Ss, Ss, Gs^Fp, Hh, Hh, Gs^Fp, Hh, Hh, Gg, Re, Re, Gs^Fp, Gg, Gs^Fp, Gg^Ve, Wo, Gs^Fp
Wo, Wo, Wo, Gg^Vh, Ww^Bw\, Rp, Rp, Rp, Rp, Wo, Wo, Gg, Re, Re, Gg, Gg, Wo, Wo, Wo, Wo, Wo, Gg, Re, Hh, Re, Gg^Vh, Re, Re, Re, Re, Re, Ss, Re, Ds, Gs^Fp, Ss, Ds, Ss, Gg^Vh, Gg, Gs^Fp, Hh, Hh, Hh, Hh, Hh, Re, Hh, Re, Gs^Fp, Gg, Gs^Fp, Gs^Fp
Wo, Wo, Wo, Ds, Ww, Gg, Gg, Gg^Vh, Rp, Wo, Wo, Ww, Ww^Bw|, Gg, Gg, Gg, Wo, Gg, Hh, Hh, Wo, Gg, Gg, Re, Gg, Re, Gg, Gg, Gg, Gg, Gg, Re, Gg, Re, Re, Ss, Ss, Gs^Fp, Ds, Ss, Gs^Fp, Gg, Gg, Gg^Efm, Gg, Gg, Gg, Re, Hh, Re, Re, Gs^Fp, Gs^Fp
Wo, Wo, Wo, Wo, Wo, Wo, Wo, Rp, Ww^Bw\, Ww, Gg, Gg, Re, Ww, Wo, Wo, Gg, Hh, Hh, Gg, Gg, Wo, Wo, Gg, Ww, Gg, Wo, Wo, Ww, Ww, Ww, Hh, Wo, Gg, Gg, Re, Re, Gg, Gg, Ds, Gg, Ss, Gg, Gg, Gs^Fp, Hh, Gg, Hh, Gg^Efm, Hh, Hh, Re, Re
Wo, Wo, Wo, Wo, Hh, Ds, Gg, Ww, Gg, Rp, Rp, Gg, Re, Re^Gvs, Re^Gvs, Wo, Gg, Hh, Hh, Hh, Hh, Gg, Gg^Vh, Ww, Gg, Ww, Gg, Gg, Gg, Gg^Ve, Gg, Wo, Gg, Wo, Wo, Gg, Gg, Re, Re, Gg, Gg^Efm, Gg, Gs^Fp, Gg, Gg, Gg, Gg, Gg, Gg, Hh, Hh, Hh, Hh
Wo, Wo, Wo, Hh, Gg^Vh, Re^Gvs, Re^Gvs, Gg, Re, Gg, Re, Rp, Rp, Re^Gvs, Gg^Vh, Gg, Gg, Gg, Hh, Mm, Mm, Hh, Re^Gvs, Re^Gvs, Gg, Gg, Gs^Fp, Gs^Fp, Gg, Gs^Fp, Gs^Fp, Gg, Hh, Gg, Gg, Wo, Hh, Gg, Re, Gg, Gg, Gs^Fp, Hh, Gg, Wo, Gg^Efm, Gg, Gs^Fp, Hh, Gg^Efm, Gg, Gg, Gg
Wo, Wo, Wo, Wo, Wo, Re, Re, Re, Gg^Vh, Re, Gg, Gg, Rp, Gg, Gs^Fp, Gs^Fp, Gs^Fp, Gs^Fp, Gg, Hh, Hh, Hh, Hh, Re^Gvs, Gg, Gs^Fp, Gs^Fp, Gg, Gs^Fp, Gs^Fp, Gs, Gs, Hh, Hh, Gg, Wo, Wo, Ww, Ww^Bw|, Ww, Wo, Wo, Wo, Wo, Gg, Wo, Wo, Gg, Gg, Gg, Gg, Gs^Fp, Gg
Wo, Wo, Wo, Wo, Wo, Hh, Gg, Gg, Re^Gvs, Gg, Rp, Rp, Gs^Fp, Gs^Fp, Gs^Fp, Hh, Gs^Fp, Gs^Fp, Gg, Gg, Hh, Mm^Xm, Mm, Hh, Hh, Gg, Gs^Fp, Gg^Ve, Gs^Fp, Gs, Gs, Gs, Ww, Ww, Gg^Vh, Gg, Wo, Hh, Re, Gg, Gg, Gg, Re^Gvs, Gg, Gg^Efm, Gg, Gg, Wo, Ww, Ww, Ww, Gg, Gg
Wo, Wo, Wo, Wo, Ds, Ds, Gg, Re^Gvs, Re^Gvs, Rp, Gs^Fp, Gs^Fp, Gs^Fp, Gs^Fp, Gs^Fp, Gs^Fp, Gs^Fp, Gs^Fp, Gg, Gg, Hh, Mm^Xm, Mm, Hh, Hh, Gs^Fp, Gs^Fp, Gs^Fp, Gs^Fp, Gs, Gs, Gs, Gs, Ww, Gg, Hh, Wo, Gg, Re, Gg, Gg, Re^Gvs, Re^Gvs, Gg, Hh, Hh, Hh, Gg, Gg, Gg^Efm, Gg, Wo, Wo
Wo, Wo, Wo, Wo, Gs^Fp, Gg, Gg, Gg, Gg, Rp, Rp, Gs^Fp, Gs^Fp, Hh, Gs^Fp, Gg^Fet, Gs^Fp, Gs^Fp, Gg, Gg, Hh, Mm^Xm, Mm, Hh, Gg, Gg, Gg, Gs^Fp, Gg, Gg, Re^Gvs, Gs, Gs, Gs, Gs, Gg, Wo, Gs^Fp, Hh, Re, Re, Gg^Vh, Gg, Gg, Hh, Mm, Hh, Gg, Gg^Efm, Gg, Gg, Gg, Gg
Wo, Wo, Wo, Gg, Hh, Gs^Fp, Wo, Wo, Wo, Gg, Rp^Vh, Gs^Fp, Gs^Fp, Gs^Fp, Gg, Gs^Fp, Gg, Gg, Gs^Fp, Gg, Hh, Mm^Xm, Hh, Hh, Rp, Gg^Vh, Gg, Gg, Gg, Re^Gvs, Re^Gvs, Gg, Gg, Gs, Gs, Hh, Gg^Vh, Wo, Wo, Hh, Gg, Re, Gg, Gg, Hh, Hh, Mm, Hh, Hh, Gg, Gg, Ss, Dd
Wo, Wo, Wo, Gg, Gg, Wo, Wo, Wo, Wo, Wo, Rp, Gg, Rp, Rp, Rp, Gg, Gg, Gs^Fp, Hh, Hh, Mm^Xm, Mm^Xm, Hh, Gg, Rp, Gg, Re^Gvs, Re^Gvs, Gg, Gg, Gg^Vh, Gg, Re^Gvs, Re^Gvs, Gs, Gs, Gg, Gg, Gg, Wo, Gs^Fp, Re, Re^Gvs, Re^Gvs, Hh, Mm, Mm, Mm, Hh, Hh, Gg, Ss, Ss
Wo, Wo, Wo, Gg^Vh, Wo, Wo, Wo, Wo, Gg, Gg, Rp, Rp, Re^Gvs, Re^Gvs, Gg, Rp, Rp, Gg, Hh, Mm, Mm, Mm, Hh, Gg, Rp, Gg, Gg, Re^Gvs, Gg, Re^Gvs, Re^Gvs, Gg, Gg, Re^Gvs, Gg, Gg, Hh, Hh, Gg, Wo, Gs^Fp, Re, Gg^Vh, Re^Gvs, Hh, Hh, Mm, Mm, Hh, Hh, Gg, Gg, Ss
Wo, Wo, Wo, Wo, Wo, Wo, Wo, Wo, Gg, Rp, Gg, Gg, Gg, Re^Gvs, Gs^Fp, Gg, Gg, Rp, Rp, Hh, Gg, Hh, Gg, Gg, Rp, Re^Gvs, Re^Gvs, Gg, Gg, Re^Gvs, Re^Gvs, Gg, Gg, Gg, Gg, Hh, Hh, Hh, Wo, Wo, Gg, Re, Gg, Gg, Gg, Hh, Hh, Hh, Hh, Gg, Gg, Dd, Ss
Wo, Wo, Wo, Wo, Wo, Wo, Wo, Ds, Rp, Rp, Gg, Gg, Ds, Ss, Ds, Ss, Gg, Gg, Gg, Rp, Rp, Gg, Gg, Rp, Rr^Vh, Re^Gvs, Rp, Rp, Rp, Rp, Rp, Rp, Rp, Gg, Gg, Gg^Vh, Wo, Wo, Hh, Gg, Re, Re, Gg, Gg, Gg, Gg, Hh, Hh, Hh, Hh, Gg, Ss, Ss
Wo, Wo, Wo, Wo, Wo, Wo, Ds, Ds, Rp, Gg, Gg, Gg^Vh, Gs^Fp, Gs^Fp, Ss, Gg^Vh, Ss, Gg, Gg, Gg, Rp, Rp, Rp, Rp, Rp, Rp, Gg, Gg, Gg, Gg, Gg, Gg^Vh, Gg, Gg, Gg, Wo, Gs^Fp, Gg, Re, Re, Gs^Fp, Re, Re, Gg, Gg, Hh, Mm, Mm, Hh, Hh, Gg, Ss, Ss
Wo, Wo, Wo, Wo, Wo, Wo, Gg^Vh, Rp, Re^Gvs, Re^Gvs, Re^Gvs, Ss, Ss, Ds, Ds, Gg, Ds, Ss, Gs^Fp, Gs^Fp, Rp, Gg, Re^Gvs, Re^Gvs, Gg, Gg, Wo, Wo, Wo, Gg, Wo, Gg, Wo, Gg, Wo, Wo, Gg, Re, Gg, Gg, Gs^Fp, Rp, Rp, Re, Gg, Gg, Mm, Mm, Hh, Gg, Gg, Dd, Ss
Wo, Wo, Wo, Wo, Ds, Gg, Rp, Rp, Gg, Re^Gvs, Re, Gg, Gg, Gs^Fp, Ss, Ss, Ss, Ss, Ss, Ds, Rp, Gg, Gg, Re^Gvs, Hh, Wo, Hh, Hh, Wo, Wo, Hh, Wo, Gg, Wo, Gs^Fp, Gg, Re, Re, Gg, Gs^Fp, Gs^Fp, Gg^Vh, Rp, Hh, Gg, Gg^Vh, Mm, Hh, Hh, Hh, Gg, Ss, Ss
Wo, Wo, Wo, Wo, Ds, Gg, Gg, Gg, Re, Re, Gs^Fp, Re, Re, Gg, Gg, Gs^Fp, Ss, Ds, Ss, Ds, Gg, Rp, Hh, Hh, Wo, Wo, Hh, Hh, Wo, Gg, Hh, Hh, Gg, Hh, Re, Re, Gg, Gg, Gs^Fp, Gg, Hh, Hh, Hh, Hh, Mm, Mm, Mm, Mm, Hh, Hh, Hh, Gg, Ss
Wo, Wo, Gg, Ds, Gg, Gg, Gg, Gg, Re, Gs^Fp, Hh, Gs^Fp, Gs^Fp, Re, Gg, Ds, Ss, Gs^Fp, Ds, Ss, Gg, Rp, Hh, Wo, Hh, Hh, Wo, Wo, Gg, Hh, Mm, Hh, Hh, Gg, Re, Gg, Gg, Gg, Gg, Gg, Hh, Mm, Mm, Mm, Mm, Mm^Xm, Mm, Mm, Hh, Hh, Hh, Gg, Dd
Ds, Re, Re, Hh, Gg, Gg, Re, Hh, Re, Gs^Fp, Gs^Fp, Gg^Fet, Gg, Re, Re, Gg, Gg, Gs^Fp, Ss, Ss, Hh, Rp, Rp, Hh, Ww, Wo, Gg, Hh, Hh, Hh, Gs^Fp, Hh, Hh, Gg, Re, Gg, Re^Gvs, Gg^Vh, Gg, Hh, Hh, Mm, Hh, Hh, Hh, Mm, Hh, Hh, Hh, Hh, Gg, Dd, Dd
Gg, Gg^Vh, Re, Hh, Re, Re, Gs^Fp, Re, Gs^Fp, Gs^Fp, Gg^Fet, Gg^Ve, Gs^Fp, Gs^Fp, Gs^Fp, Re, Re, Gg, Gg, Hh, Hh, Mm, Rp, Hh, Ww, Ww, Hh, Hh, Hh, Gs^Fp, Gs^Fp, Gs^Fp, Gg, Gg, Re, Gg, Gg, Re^Gvs, Hh, Hh, Hh, Hh, Gg, Hh, Gg, Hh, Gg, Hh, Gg, Gg, Gg, Dd, Ss
Re^Gvs, Re^Gvs, Gg, Re, Gg, Gs^Fp, Gg, Gs^Fp, Gs^Fp, Hh, Gs^Fp, Gs^Fp, Gs^Fp, Gs^Fp, Wo, Gg, Gg, Re, Gg, Hh, Wo, Hh, Ww^Bw|, Ww, Hh, Hh, Mm, Mm, Hh, Gs^Fp, Gg, Gs^Fp, Re, Re, Gg, Gg, Gg, Gg, Hh, Mm, Hh, Hh, Gg, Gg, Ss, Gg, Ss, Gg, Ss, Dd, Dd, Ss, Ss
Gg, Re^Gvs, Hh, Gg, Gg, Gs^Fp, Gg, Gs^Fp, Gs^Fp, Gs^Fp, Ww, Ww, Ww, Wo, Gs^Fp, Wo, Ww, Ww^Bw|, Ww, Wo, Hh, Ww, Rp, Hh, Hh, Mm, Hh, Hh, Gg, Gg, Re, Re, Re^Gvs, Re^Gvs, Gg, Gg, Gg, Hh, Mm, Mm, Hh, Gg, Ss, Ss, Dd, Ss, Ss, Ss, Dd, Ss, Ss, Ss, Dd
Wo, Hh, Gg, Gg, Gs^Fp, Gg^Ve, Gs^Fp, Gg^Fet, Wo, Ww, Gg^Ve, Gs^Fp, Gs^Fp, Gs^Fp, Hh, Gs^Fp, Gg, Re, Gg, Hh, Dd, Gg^Vh, Gg, Hh, Dd, Gg, Gg, Gg, Gg, Re, Gg, Gg, Gg^Vh, Re^Gvs, Gg, Gg, Gg, Hh, Hh, Hh, Gg, Gg, Dd, Ss, Ss, Ss, Gg, Gg, Dd, Ss, Dd, Dd, Dd
Gg, Wo, Wo, Wo, Wo, Gs^Fp, Wo, Wo, Gs^Fp, Gg^Fet, Gg, Gg, Gs^Fp, Gg^Fet, Gg^Ve, Gs^Fp, Gg, Re, Gg, Dd, Dd, Gg, Dd, Dd, Dd, Hd, Dd, Gg^Vh, Rd, Rd, Dd, Gg, Dd, Gg, Dd, Gg, Dd, Dd, Dd, Dd, Gg, Dd, Dd, Ss, Dd, Dd, Dd, Ss^Vhs, Ss, Hd, Dd^Dc, Dd, Dd
Gg, Gs, Gs, Gs, Gs, Wo, Gs^Fp, Gs^Fp, Gs^Fp, Gs^Fp, Gs^Fp, Gs^Fp, Gs^Fp, Gs^Fp, Gs, Gg, Rd, Rd, Dd, Dd, Dd, Dd, Hd, Dd, Dd, Dd, Dd^Dc, Rd, Dd, Dd, Hd, Dd, Dd, Dd^Dc, Hd, Dd, Dd^Do, Dd, Dd, Hd, Ss, Ss^Vhs, Dd^Dc, Dd, Ss, Dd, Hd, Ss, Dd, Dd, Ss, Dd, Dd
Dd, Dd, Dd, Dd, Dd, Gs, Gs, Gs, Gs, Gs^Fp, Gs^Fp, Gs^Fp, Gs, Gs, Gs, Rd, Dd, Dd, Dd, Dd, Dd, Dd, Dd, Dd, Dd, Dd, Dd, Rd, Dd, Dd, Dd, Dd, Dd, Dd, Dd, Dd, Dd, Dd, Dd, Dd, Dd, Ss, Dd, Dd, Ss, Ss, Dd, Dd, Ss, Ss, Ss, Dd, Dd
Xv, Xv, Xv, Xv, Xv, Xv, Xv, Xv, Xv, Xv, Xv, Xv, Xv, Xv, Xv, Xv, Xv, Xv, Xv, Xv, Xv, Xv, Xv, Xv, Xv, Xv, Xv, Xv, Xv, Xv, Xv, Xv, Xv, Xv, Xv, Xv, Xv, Xv, Xv, Xv, Xv, Xv, Xv, Xv, Xv, Xv, Xv, Xv, Xv, Xv, Xv, Xv, Xv
Xv, Xv, Xv, Xv, Xv, Xv, Xv, Xv, Xv, Xv, Xv, Xv, Xv, Xv, Xv, Xv, Xv, Xv, Xv, Xv, Xv, Xv, Xv, Xv, Xv, Xv, Xv, Xv, Xv, Xv, Xv, Xv, Xv, Xv, Xv, Xv, Xv, Xv, Xv, Xv, Xv, Xv, Xv, Xv, Xv, Xv, Xv, Xv, Xv, Xv, Xv, Xv, Xv
Xv, Xv, Xv, Xv, Xv, Xv, Xv, Xv, Xv, Xv, Xv, Xv, Xv, Xv, Xv, Xv, Xv, Xv, Xv, Xv, Xv, Xv, Xv, Xv, Xv, Xv, Xv, Xv, Xv, Xv, Xv, Xv, Xv, Xv, Xv, Xv, Xv, Xv, Xv, Xv, Xv, Xv, Xv, 9 Xv, Xv, 1 Xv, Xv, 2 Xv, Xv, 3 Xv, Xv, Xv, Xv
Xv, Xv, Xv, Xv, Xv, Xv, Xv, Xv, Xv, Xv, Xv, Xv, Xv, Xv, Xv, Xv, Xv, Xv, Xv, Xv, Xv, Xv, Xv, Xv, Xv, Xv, Xv, Xv, Xv, Xv, Xv, Xv, Xv, Xv, Xv, Xv, Xv, Xv, Xv, Xv, Xv, Xv, Xv, Xv, Xv, Xv, Xv, Xv, Xv, Xv, Xv, Xv, Xv
Xv, Xv, Xv, Xv, Xv, Xv, Xv, Xv, Xv, Xv, Xv, Xv, Xv, Xv, Xv, Xv, Xv, Xv, Xv, Xv, Xv, Xv, Xv, Xv, Xv, Xv, Xv, Xv, Xv, Xv, Xv, Xv, Xv, Xv, Xv, Xv, Xv, Xv, Xv, Xv, Xv, Xv, Xv, 8 Xv, Xv, 6 Xv, Xv, 5 Xv, Xv, 4 Xv, Xv, Xv, Xv
Xv, Xv, Xv, Xv, Xv, Xv, Xv, Xv, Xv, Xv, Xv, Xv, Xv, Xv, Xv, Xv, Xv, Xv, Xv, Xv, Xv, Xv, Xv, Xv, Xv, Xv, Xv, Xv, Xv, Xv, Xv, Xv, Xv, Xv, Xv, Xv, Xv, Xv, Xv, Xv, Xv, Xv, Xv, Xv, Xv, Xv, Xv, Xv, Xv, Xv, Xv, Xv, Xv
Xv, Xv, Xv, Xv, Xv, Xv, Xv, Xv, Xv, Xv, Xv, Xv, Xv, Xv, Xv, Xv, Xv, Xv, Xv, Xv, Xv, Xv, Xv, Xv, Xv, Xv, Xv, Xv, Xv, Xv, Xv, Xv, Xv, Xv, Xv, Xv, Xv, Xv, Xv, Xv, Xv, Xv, Xv, Xv, Xv, Xv, Xv, Xv, Xv, Xv, Xv, Xv, Xv
