Wo, Wo, Ww, Ww, Wwf, Ww, Ai, Ww, Wwf, Ai, Wwf, Ww, Wwf, Ai, Wwf, Ai, Wwf, Ai, Ww, Ww, Ai, Ww, Ww, Ai, Aa, Aa, Aa, Aa, Aa, Aa, Ai, Ww, Wo, Wo, Wo, Wo, Wo, Wo, Wo, Wo, Wo, Wo, Wo, Wo, Wo, Wo, Wo, Wo, Wo, Wo, Wo, Wo, Wo, Wo, Ww, Ww, Ww, Ww, Ww, Wo, Wo, Wo, Wo, Wo, Wo, Wo, Wo, Wo, Wo, Wo, Wo, Wo, Wo, Wo, Ww, Wo, Wo, Wo, Wo, Wo, Wo, Wo, Wo, Wo, Wo, Wo, Wo, Wo, Wo, Wo, Wo, Wo
Wo, Ww, Ai, Ai, Ww, Ai, Wwf, Ww, Ai, Wwf, Ww, Ai, Ai, Wwf, Ww, Ai, Ai, Wwf, Wo, Wwf, Ww, Wwf, Ww, Ai, Aa, Aa, Aa, Aa, Aa, Aa, Ai, Ww, Wo, Wo, Wo, Wo, Wo, Wo, Wo, Wo, Wo, Wo, Wo, Wo, Wo, Wo, Wo, Wo, Wo, Wo, Wo, Wo, Ww, Ww, Aa, Aa, Aa, Ha, Ha, Ww, Wo, Wo, Wo, Wo, Wo, Wo, Ww, Ww, Ww, Ww, Ww, Wo, Ww, Ww, Aa, Ww, Ww, Ww, Ww, Ww, Ww, Wo, Ww, Wo, Wo, Wo, Wo, Wo, Wo, Ww, Ww, Wo
Ww, Wwf, Ww, Wwf, Wwf, Ai, Wwf, Ai, Wwf, Ai, Ww, Wwf, Ww, Ww, Wwf, Ww, Ww, Ww, Ww, Ww, Ai, Wwf, Wwf, Ai, Ai, Aa, Aa, Aa, Aa, Ai, Ww, Ww, Wo, Wo, Wo, Wo, Wo, Wo, Wo, Wo, Wo, Wo, Ww, Ww, Ww, Ww, Ww, Wo, Wo, Wo, Ww, Ww, Aa, Aa, Aa, Gg, Aa, Aa, Aa, Ww, Ww, Ww, Ww, Ww, Ww, Ww, Aa^Fpa, Gg, Gg, Aa, Aa, Ww, Gg, Aa, Aa^Fpa, Aa, Aa, Aa, Aa^Fpa, Aa, Aa, Ww, Aa, Ww, Ww, Ww, Ww, Wo, Ww, Ww, Aa, Ww
Aa, Aa, Aa, Gg, Aa, Ww, Aa, Ww, Aa, Ww, Aa, Ww, Wwf, Aa, Gg, Aa, Wwf, Ww, Ai, Wwf, Ww, Ww, Ww, Ww, Ai, Aa, Aa, Aa, Aa, Ai, Ww, Wo, Wo, Wo, Wo, Wo, Wo, Wo, Wo, Wo, Wo, Ww, Aa^Fpa, Aa, Gg, Aa, Ha, Ww, Ww, Ww, Aa, Ww, Aa, Ha, Aa^Fpa, Aa, Gg, Gg, Aa, Aa, Aa, Aa, Aa, Aa, Aa^Fpa, Aa^Fpa, Aa^Fpa, Aa^Fpa, Aa^Fpa, Aa, Gg, Aa, Ha, Aa, Gg, Aa, Ha, Gg, Aa^Fpa, Aa^Fpa, Gg, Aa, Gg, Aa, Aa, Aa^Fpa, Aa^Fpa, Ww, Aa, Wwf, Aa^Fpa, Aa
Aa, Ha, Gg, Ha, Ha, Aa, Gg, Aa, Ha, Aa, Aa, Aa, Aa, Aa, Gg, Aa, Aa, Ww, Ai, Wwf, Wo, Ww, Ai, Wwf, Ai, Aa, Aa, Aa, Ai, Ai, Ww, Wo, Wo, Wo, Wo, Wo, Wo, Wo, Wo, Wo, Ww, Ww, Hh, Gg, Wwf, Gg, Gg, Aa^Fpa, Wwf, Gg, Aa, Aa, Gg, Gg, Aa^Fpa, Aa, Aa, Aa^Fpa, Aa, Aa, Gg, Gg, Aa^Fpa, Aa^Fpa, Aa^Fpa, Gs^Fp, Aa^Fpa, Aa^Fpa, Aa^Fpa, Aa^Fpa, Aa, Aa, Aa, Aa, Gg, Aa, Gg, Gg, Aa, Ha, Aa, Gg, Aa, Aa, Wwf, Aa, Wwf, Wwf, Wwf, Aa, Ha, Gg
Aa, Aa^Fpa, Aa^Fpa, Gg, Gg, Gg, Aa^Fpa, Hh, Hh, Gg, Gg, Gg, Gg, Aa, Aa^Fpa, Aa, Aa^Fpa, Wwf, Aa, Ai, Aa, Ww, Ww, Wwf, Ww, Ai, Aa, Ai, Wwf, Ww, Aa^Vea, Ww, Ww, Wo, Wo, Wo, Wo, Wo, Wo, Wo, Ww, Aa^Fpa, Hh, Wwf, Ww, Gs^Fp, Gs^Fp, Wwf, Aa, Aa, Aa^Fpa, Gg, Aa, Aa, Gg, Gg, Gg, Aa, Gg, Aa, Aa, Aa, Aa^Fpa, Aa^Fpa, Aa^Fpa, Aa^Fpa, Gs^Fp, Aa^Fpa, Gs^Fp, Aa^Fpa, Aa^Fpa, Gg, Hh, Aa, Aa, Aa^Fpa, Aa, Aa, Gs^Fp, Aa, Gs^Fp, Aa, Aa^Fpa, Aa, Wwf, Wwf, Wo, Wo, Wwf, Aa^Fpa, Wwf, Aa^Fpa
Ww, Aa, Wwf, Gg, Wwf, Gg, Ha, Gg, Hh, Ha, Gg, Gg, Aa^Fpa, Gg, Gg, Gg, Wwf, Ww, Ww, Aa, Ww, Wo, Wwf, Wo, Wo, Wwf, Aa^Vea, Ai, Ww, Ww, Ww, Wwf, Wwf, Ww, Ww, Ww, Ww, Wo, Wo, Ww, Gs^Fp, Gs, Gg^Ve, Ww, Ww, Wwf, Gg, Hh, Hh, Mm, Mm, Gg, Mm, Gg, Gg, Gg, Gg, Aa^Vha, Gg, Hh, Gg, Gg, Gg, Hh, Hh, Aa^Fpa, Aa^Fpa, Aa^Fpa, Aa^Fpa, Aa^Fpa, Gg, Gg, Aa^Vha, Aa, Wwf, Wwf, Wwf, Ww, Ww, Gg, Wwf, Wwf, Wwf, Wwf, Wo, Wo, Wo, Wo, Wo, Wwf, Wwf, Wwf
Ww, Wwf, Aa, Aa, Wwf, Wwf, Gs^Fp, Hh, Gg, Aa, Gg, Aa, Gg, Gs^Fp, Aa, Wwf, Ww, Ww, Aa, Ww, Gg, Ww, Aa, Ww, Wwf, Ww, Ww, Ww, Wo, Wo, Wo, Wo, Ww, Wwf, Ww, Hh, Ww, Wo, Wo, Ww, Ww, Wwf, Ww, Ww, Ww, Gg, Hh, Gg, Gg, Gg, Gg, Hh, Hh, Gg, Gg, Gg, Gg, Gg, Gg, Gg, Gg, Gg, Gg, Gg, Gg, Gg, Gg, Gg, Gg, Gg, Gg, Gg, Gg, Gg, Hh, Hh, Gs^Fp, Ww, Ww, Gg, Gg, Hh, Wwf, Wo, Wo, Wo, Ww, Wo, Ww, Ww, Ai, Aa
Aa, Aa, Ww, Ww, Ww, Gg^Vh, Gs^Fp, Mm, Ha, Gs^Fp, Gs^Fp, Gs^Fp, Gg, Gg, Gs^Fp, Wwf, Aa, Wwf, Gs^Fp, Aa, Wwf, Wwf, Gg, Aa, Ww, Wo, Wo, Wo, Wo, Wo, Wo, Wo, Ww, Ww, Wwf, Hh, Gs^Fp, Ww, Ww, Wo, Ww, Hh, Wwf, Wwf, Gg, Gg, Gs^Fp, Gs^Fp, Gs^Fp, Hh, Gg^Ve, Hh, Mm, Gs^Fp, Gg, Hh, Gs^Fp, Gg, Gg, Gg, Gs^Fp, Gg, Gg, Gg, Gs^Fp, Gg, Gg, Gg, Hh, Gg, Gs^Fp, Gg, Gg, Gg, Gg, Gg, Gg, Gg, Ww, Ww, Wwf, Gg, Ww, Wo, Wo, Ww, Ai, Ww, Ai, Wwf, Ww, Ww
Ww, Ww, Wwr, Wo, Ww, Gs^Fp, Hh, Mm, Gg, Gs^Fp, Gg, Gg^Vh, Hh, Gs^Fp, Ww, Gs^Fp, Ww, Gs^Fp, Gg^Vh, Gg, Ww, Ww, Ww, Ww, Wo, Wo, Wo, Wo, Wo, Wo, Wo, Wo, Ww, Hh, Wwf, Gg^Ve, Ww, Ww, Gg, Ww, Gs, Gg, Gg, Gg^Ve, Hh, Gg, Gg, Gg, Gs^Fp, Gg, Gg, Gs^Fp, Mm, Hh, Gg, Hh, Gg, Gg, Gg, Gg, Hh, Hh, Hh, Gg, Hh, Gs^Fp, Mm, Hh, Mm, Gg, Gg, Gg, Gg, Gg, Gg, Gg, Gg, Hh, Ww, Gg, Wwf, Ww, Wo, Wo, Wo, Ww, Ww, Ww, Ww, Ww, Ww, Ww
Wo, Wo, Wo, Wo, Ww, Gg, Gg, Mm, Hh, Gg, Gs^Fp, Gg, Gs^Fp, Ww, Gg, Ww, Gg, Hh, Gg, Ww, Wo, Wo, Wo, Wo, Wo, Wo, Wo, Wo, Wo, Wo, Wo, Wo, Wo, Ww, Ww, Ww, Gs, Gg^Ve, Gg, Gs, Gg^Ve, Gs^Fp, Gs, Mm, Mm, Gg, Gg, Gs^Fp, Hh, Gg, Gs^Fp, Gs^Fp, Mm, Hh, Gs^Fp, Gg, Gg^Vh, Gg, Gg, Gg, Mm, Mm, Mm, Mm, Mm, Mm, Hh, Hh, Hh, Hh, Gg, Gg, Gg^Vh, Hh, Gs, Gs, Wwf, Gg^Vh, Gg, Ww, Gg, Ww, Ww, Wo, Wo, Wo, Wo, Wo, Wo, Wo, Wo, Wo
Wo, Wo, Wo, Wo, Ww, Gs^Fp, Gg, Mm, Hd, Gs^Fp, Gs, Gs, Gs, Gs^Fp, Gg, Ww, Mm, Gg, Gs^Fp, Ww, Wo, Wo, Wo, Wo, Wo, Wo, Wo, Wo, Wo, Wo, Wo, Wo, Wo, Wo, Ww, Hh, Gs^Fp, Gg, Hh, Mm, Hh, Gg, Gg, Gs, Mm, Hh, Wwf, Gs^Fp, Wwf, Gg, Ww, Ww, Gs^Fp, Gg, Gg, Gg, Gg, Gg, Hh, Mm, Mm^Xm, Mm^Xm, Mm^Xm, Mm^Xm, Dd, Hh, Dd, Dd, Dd, Gs^Fp, Gg, Gg, Gg, Gg, Gg, Wwf, Gs^Fp, Ww, Gg, Ww, Wwf, Mm, Ww, Wo, Wo, Wo, Wo, Wo, Wo, Wo, Wo, Wo
Wo, Wo, Wo, Wo, Wo, Ww, Gg^Vh, Hh, Hd, Mm, Gs, Gs, Gs, Gs, Gs, Hh, Hh, Gg^Vh, Ww, Ww, Wo, Wo, Wo, Wo, Wo, Wo, Wo, Wo, Wo, Wo, Wo, Wo, Ww, Ww, Hh, Gg, Ww, Ww, Ww, Gg, Wwf, Wwf, Hh, Mm, Gg, Gg, Ww, Ww, Ww, Hh, Gs^Fp, Ww, Gs^Fp, Hh, Gg, Gg, Gg, Gs^Fp, Hh, Hh, Mm^Xm, Mm^Xm, Mm^Xm, Dd, Mm, Dd, Dd, Dd, Hh, Gg, Gg, Gs^Fp, Gg, Gg, Gg, Gs, Gs, Ww, Ww, Ww, Hh, Gs^Vht, Ww, Wo, Wo, Wo, Wo, Wo, Wo, Wo, Wo, Wo
Wo, Wo, Wo, Wo, Wo, Ww, Ww, Mm, Mm, Dd, Gs, Gs, Gs, Gs, Hh, Mm, Hh, Gg, Ww, Wo, Wo, Wo, Wo, Wo, Wo, Wo, Wo, Wo, Wo, Wo, Wo, Wo, Ww, Gg, Gg^Ve, Gs, Ww, Wo, Ww, Gg^Ve, Gs^Fp, Ww, Wwf, Hh, Gg, Wwf, Ww, Wo, Ww, Gg, Gg, Ww, Gg, Gg, Dd, Gs, Gs, Gs^Fp, Hh, Mm, Mm^Xm, Mm^Xm, Mm^Xm, Mm^Xm, Mm, Mm, Mm, Hh, Dd, Dd, Gg, Gg, Gs^Fp, Hh, Gg, Hh, Gg, Wwf, Ww, Gs^Fp, Wwf, Ww, Ww, Wo, Wo, Wo, Wo, Wo, Wo, Wo, Wo, Wo
Wo, Wo, Wo, Wo, Wo, Wo, Ww, Hh, Wwf, Mm, Hh, Gg, Gg^Vh, Ss, Ss, Gg, Gg, Ww, Wo, Wo, Wo, Wo, Wo, Wo, Wo, Wo, Wo, Wo, Wo, Wo, Wo, Wo, Wo, Ww, Wwf, Ww, Wo, Wo, Hh, Wwf, Ww, Ww, Ww, Hh, Gg^Ve, Ww, Gg, Ww, Gg, Dd, Dd, Dd, Hh, Gg, Dd^Vda, Dd, Gs, Gs, Gg, Mm, Mm, Mm, Mm, Mm, Hh, Mm, Mm, Hh, Dd, Dd, Hh, Gg, Gg, Gg^Vh, Hh, Mm, Gs, Ww, Wo, Ww, Ww, Gs^Ft, Ww, Wo, Wo, Wo, Wo, Wo, Wo, Wo, Wo, Wo
Wo, Wo, Wo, Wo, Wo, Wo, Ww, Gg, Wwf, Mm, Md, Gg, Gg, Wwf, Ww, Wwf, Gg, Ww, Ww, Ww, Ww, Wo, Wo, Wo, Wo, Wo, Wo, Wo, Wo, Wo, Wo, Wo, Ww, Ww, Gs^Vht, Ww, Ww, Wo, Wo, Wo, Wo, Wo, Wo, Wo, Wo, Wwf, Ww, Hh, Mm, Gg, Dd^Vda, Gs, Gs, Dd, Dd, Dd, Gs, Dd, Hh^Vhh, Mm, Dd, Hh, Gg, Hh, Gg, Hh, Hh, Gs^Fp, Gs^Fp, Dd, Gs^Fp, Gs^Fp, Gs, Gg, Gs, Gs, Ww, Ww, Wo, Wo, Wo, Ww, Wo, Wo, Wo, Wo, Ww, Ww, Ww, Wo, Wo, Wo
Wo, Wo, Wo, Wo, Wo, Wo, Ww, Dd, Dd, Ww, Md, Dd, Wwf, Ww, Ww, Ww, Ww, Ww, Ww, Hh, Ww, Wo, Wo, Wo, Wo, Wo, Wo, Wo, Wo, Wo, Ww, Ww, Gs, Gs, Dd, Gs, Gs^Fp, Gs, Wwf, Ww, Ww, Ww, Gs^Fp, Wwf, Ww, Wo, Ww, Gg, Hh, Dd, Dd, Ww, Ww, Ww, Ww, Dd, Gs, Dd, Mm, Hh, Dd, Gg, Gs^Fp, Gg, Gg, Gg, Gg^Vc, Hh, Hh, Gg, Gg, Gs, Wwf, Gg, Ww, Ww, Wo, Wo, Wo, Wo, Wo, Wo, Wo, Wo, Wo, Wo, Ww, Hh, Wwf, Ww, Ww, Wo
Wo, Wo, Wo, Wo, Wo, Wo, Wo, Ww, Ww, Ww, Ww, Dd^Vda, Dd, Ww, Ww, Gs^Fp, Gg^Vh, Hh, Wwf, Ww, Wo, Wo, Wo, Wo, Wo, Wo, Wo, Wo, Wo, Ww, Gs, Gs, Hd, Md, Md, Md, Hd, Gs, Gs, Gs, Gs, Wwf, Gg, Gg, Gg^Vc, Ww, Ss, Gg^Vh, Gs, Dd, Dd, Dd, Dd, Gs^Fp, Ww, Ww, Ww, Wwf, Gs, Dd, Gg, Gg^Vh, Gg, Hh, Gg, Wwf, Wwf, Mm, Hh, Gg, Gs, Wwf, Ww, Gs, Ww, Wo, Ww, Ww, Ww, Wo, Wo, Wo, Wo, Wo, Wo, Wo, Wo, Wwf, Gg, Mm, Ww, Wo
Wo, Wo, Wo, Wo, Wo, Wo, Wo, Wo, Wo, Wo, Ww, Md, Gs, Gs, Ww, Wwf, Ww, Wwf, Wwf, Wo, Wo, Wo, Wo, Wo, Wo, Wo, Wo, Wo, Wo, Ww, Gs, Dd, Dd, Dd, Dd, Dd, Dd, Dd, Dd, Hd, Dd, Gs, Md, Gs^Fp, Gg, Ww, Gs, Wwf, Wwf, Hh, Mm, Dd^Do, Hh, Dd, Ww, Wo, Wo, Ww, Ww, Gs, Hh, Gs^Fp, Gs, Gs, Ww, Ww, Ww, Mm, Mm, Gs^Ft, Gg, Wwf, Gg, Ww, Wwf, Ww, Gs^Ft, Gs^Ft, Gg, Ww, Wo, Wo, Wo, Wo, Wo, Wo, Wo, Ww, Ww, Ww, Wo, Wo
Wo, Wo, Wo, Wo, Wo, Wo, Wo, Wo, Wo, Wo, Wo, Ww, Sm^Vhs, Wwf, Wwf, Ww, Ww, Wo, Ww, Ww, Ww, Wo, Wo, Wo, Wo, Wo, Wo, Wo, Ww, Ww, Gs, Dd, Dd, Dd^Do, Hd, Md, Dd, Dd^Do, Dd, Hd, Dd, Hd, Hd, Gs, Wwf, Wwf, Gs^Fp, Gg, Hh, Ww, Wwf, Dd^Vdt, Gs, Gs, Ww, Wo, Wo, Wo, Ww, Gs, Gg, Gg, Gs, Ww, Wo, Wo, Ww, Mm^Xm, Mm, Hh, Dd, Gs^Ft, Wwf, Ww, Ww, Gg, Gs^Ft, Ww, Ww, Ww, Wo, Wo, Wo, Wo, Wo, Wo, Wo, Wo, Wo, Wo, Wo, Wo
Wo, Wo, Wo, Wo, Wo, Wo, Wo, Wo, Wo, Wo, Wo, Ww, Ww, Gs, Gg, Ww, Hh, Ww, Gg^Vh, Ww, Ww, Ww, Ww, Ww, Ww, Ww, Ww, Ww, Wwf, Wwf, Wwf, Gs, Hd, Dd, Dd, Hd, Dd, Dd, Dd, Md, Hd, Dd^Do, Dd, Gs, Gs, Gs, Hd, Hh, Ww, Ww, Ww, Hh, Ww, Ww, Wo, Wo, Wo, Wo, Wo, Ww, Gs^Fp, Hh, Gg, Ww, Wo, Wo, Wo, Ww, Gs^Ft, Gg^Vh, Gs^Ft, Gs^Ft, Ww, Ww, Gs^Fp, Wwr, Wwr, Wwf, Gs^Fp, Ww, Wo, Wo, Wo, Wo, Wwr, Wo, Wo, Wo, Wo, Wo, Wo, Wo
Wo, Wo, Wo, Wo, Wo, Wo, Wo, Wo, Wo, Wo, Wo, Ww, Mm, Gg, Gg^Vh, Wwf, Gs^Ft, Gg, Gg, Wwf, Gs^Ft, Ww, Wwf, Wwf, Wwf, Wwf, Wwf, Wwf, Ww, Wwf, Ww, Gs, Gs, Dd, Gs^Vht, Dd, Dd, Dd, Hd, Dd, Dd, Dd, Dd, Hd, Md, Dd^Vda, Gg, Gg, Ww, Wo, Wo, Ww, Wo, Wo, Wo, Wo, Wo, Wo, Wo, Ww, Ww, Gs^Fp, Ww^Vm, Ww, Wo, Wo, Wo, Ww, Gs^Ft, Wwf, Ww, Ww, Wo, Ww, Wwr, Ww, Gg^Vc, Ww, Wwf, Ww, Ww, Wo, Wo, Wo, Wo, Wo, Wo, Wo, Wo, Wo, Wo, Wo
Wo, Wo, Wo, Wo, Wo, Wo, Wo, Wo, Wo, Wo, Ww, Ww, Mm, Hh, Gs^Ft, Gs^Ft, Gs^Ft, Hh, Wwf, Gg, Wwf, Wwf, Gg, Wwf, Ww, Wwf, Ww, Ww, Wo, Ww, Wo, Ww, Ww, Gs^Ft, Wwf, Gs^Ft, Gs, Hd, Gs^Ft, Gs, Mm, Ww, Gs, Dd, Gg, Gg, Ww, Ww, Wo, Wo, Wo, Wo, Wo, Wo, Wo, Wo, Wo, Wo, Wo, Wo, Wo, Ww, Ww, Ww, Wo, Wo, Wo, Ww, Ww, Gg, Gg, Ww, Ww, Ww, Gg, Wwf, Wwr, Wwf, Ww, Gg, Ww, Wo, Wo, Wo, Wo, Wo, Wo, Wo, Wo, Wo, Wo, Wo
Wo, Wo, Wo, Wo, Wo, Wo, Wo, Wo, Wo, Wo, Ww, Mm, Gs, Gs^Ft, Mm, Gs, Wwf, Wwf, Gs^Ft, Wwf, Hh, Gg, Gs^Ft, Gg, Ww, Ww, Wo, Wo, Wo, Wo, Wo, Wo, Wo, Ww, Ww, Gs^Ft, Gs^Ft, Gs, Gs, Gs, Ww, Ww, Gs, Gg, Gg, Ww, Wo, Wo, Wo, Wo, Wo, Wo, Wo, Wo, Wo, Wo, Wo, Wo, Wo, Wo, Wo, Wo, Wo, Wo, Wo, Wo, Wo, Ww, Gg, Wwf, Ww, Wwf, Hh, Hh, Wwf, Ww, Gs^Ft, Gg, Ww, Ww, Wo, Wo, Wo, Wo, Wo, Wo, Wo, Wo, Wo, Wo, Wo, Wo
Wo, Wo, Wo, Wo, Wo, Wo, Wo, Wo, Wo, Wo, Ww, Mm, Mm, Gs^Ft, Hh, Wwf, Gs^Ft, Gs^Ft, Wwf, Wwf, Gs^Ft, Gg, Gg, Gg, Ww, Wo, Wo, Wo, Wo, Wo, Wo, Wo, Wo, Wo, Ww, Gs, Gs^Ft, Gs, Gs^Vht, Gs, Gs, Ww, Gs^Ft, Gs, Ww, Ww, Ww, Wo, Wo, Wo, Wo, Wo, Wo, Wo, Wo, Wo, Wo, Wo, Wo, Wo, Wo, Wo, Wo, Wo, Wo, Wo, Wo, Ww, Gs^Ft, Gs^Ft, Gs^Ft, Ww, Gg^Vh, Mm, Gg, Wwf, Gg, Wwf, Ww, Wo, Wo, Wo, Wo, Wo, Wo, Wo, Wo, Wo, Wo, Wo, Wo, Wo
Wo, Wo, Wo, Wo, Wo, Wo, Wo, Wo, Wo, Wo, Wo, Ww, Hh, Mm^Vc, Gs, Gs, Mm, Hh, Wwf, Gs^Ft, Gg^Vh, Hh, Gg, Ww, Wo, Wo, Wo, Wo, Wo, Wo, Wo, Wo, Wo, Wo, Ww, Dd, Dd, Gs, Gs, Hh, Hh, Gs^Ft, Gs, Gs, Ww, Gg, Gs, Ww, Wo, Wo, Wo, Wo, Wo, Wo, Wo, Wo, Wo, Wo, Wo, Wo, Wo, Wo, Wo, Wo, Wo, Wo, Wo, Ww, Ww, Wwf, Gg, Ww, Wwf, Hh, Ww, Ww, Wwf, Gg, Wwf, Ww, Ww, Ww, Ww, Wo, Wo, Wo, Wo, Wo, Wo, Wo, Wo, Wo
Wo, Wo, Wo, Wo, Wo, Wo, Wo, Wo, Wo, Wo, Wo, Ww, Gg, Mm, Gs^Ft, Gs, Hh, Gs^Ft, Gs^Ft, Hh, Gs, Gs, Ww, Ww, Wo, Wo, Wo, Wo, Wo, Wo, Wo, Wo, Wo, Wo, Ww, Dd, Dd, Gs, Gs, Mm, Gs, Gs, Gs^Ft, Gs, Ww, Gs^Vht, Gs^Ft, Ww, Wo, Wo, Wo, Wo, Wo, Wo, Wo, Wo, Wo, Wo, Wo, Wo, Wo, Wo, Wo, Wo, Wo, Wo, Wo, Wo, Wo, Ww, Ww, Gg, Wwf, Ww, Ww, Wwf, Ww, Ww, Gg, Gs^Ft, Gs^Ft, Gs^Ft, Gg^Vc, Wwf, Wo, Wo, Wo, Wo, Wo, Wo, Wo, Wo
Wo, Wo, Wo, Wo, Wo, Wo, Wo, Wo, Wo, Wo, Wo, Ww, Gg, Mm, Gs, Gs, Gs^Ft, Gs^Ft, Gs, Gs, Ww, Ww, Wo, Wo, Wo, Wo, Wo, Wo, Wo, Wo, Wo, Wo, Wo, Wo, Ww, Dd, Gs, Gs, Hh, Gs^Ft, Gs, Gs, Wwf, Ww, Gs, Gs^Ft, Ww, Ww, Wo, Wo, Wo, Wo, Wo, Wo, Wo, Wo, Wo, Wo, Wo, Wo, Wo, Wo, Wo, Wo, Wo, Wo, Wo, Wo, Wo, Wo, Wo, Ww, Ww, Gg, Gg, Gs^Fp, Ww, Ww, Ww, Gg, Ww, Gs^Ft, Ww, Ww, Wo, Wo, Wo, Wo, Wo, Wo, Wo, Wo
Wo, Wo, Wo, Wo, Wo, Wo, Wo, Wo, Wo, Wo, Wo, Ww, Gs, Mm, Mm, Gs, Gs^Ft, Gs, Hh, Gs, Ww, Wo, Wo, Wo, Wo, Wo, Wo, Wo, Wo, Wo, Wo, Wo, Wo, Wo, Ww, Gs^Ft, Gs^Vht, Hh, Hh, Gs, Hh, Gs, Ww, Ww, Ww, Ww, Wo, Wo, Wo, Wo, Wo, Wo, Wo, Wo, Wo, Wo, Wo, Wo, Wo, Wo, Wo, Wo, Wo, Wo, Wo, Wo, Wo, Wo, Wo, Wo, Wo, Wo, Wo, Ww, Wwf, Ww, Gs, Ww, Gs, Wwf, Wwf, Ww, Wo, Wo, Wo, Wo, Wo, Wo, Wo, Wo, Wo, Wo
Wo, Wo, Wo, Wo, Wo, Wo, Wo, Wo, Wo, Wo, Wo, Ww, Ww, Gs, Mm, Gs^Ft, Gs, Gs, Gs, Gg^Vh, Ww, Wo, Wo, Wo, Wo, Wo, Wo, Wo, Wo, Wo, Wo, Wo, Wo, Wo, Wo, Ww, Ww, Gs, Gs, Gs^Ft, Gs, Gs, Ww, Wo, Wo, Wo, Wo, Wo, Wo, Wo, Wo, Wo, Wo, Wo, Wo, Wo, Wo, Wo, Wo, Wo, Wo, Wo, Wo, Wo, Wo, Wo, Wo, Wo, Wo, Wo, Wo, Wo, Ww, Ww, Gs, Gs, Gs^Fp, Wwf, Gg, Gs, Gs, Ww, Ww, Wo, Wo, Wo, Ww, Ww, Ww, Wo, Wo, Wo
Wo, Wo, Wo, Wo, Wo, Wo, Wo, Wo, Wo, Wo, Wo, Wo, Ww, Gs^Vht, Mm, Gs^Ft, Hh, Gs, Ww, Ww, Wo, Wo, Wo, Wo, Wo, Wo, Wo, Wo, Wo, Wo, Wo, Wo, Wo, Wo, Wo, Wo, Wo, Ww, Ww, Ww, Ww, Ww, Wo, Wo, Wo, Wo, Wo, Wo, Wo, Wo, Wo, Wo, Wo, Wo, Wo, Wo, Wo, Wo, Wo, Wo, Wo, Wo, Wo, Wo, Wo, Wo, Wo, Wo, Wo, Wo, Wo, Ww, Mm, Hh, Gg, Dd, Dd, Gg, Hd, Mm, Hd, Gs, Ww, Wo, Wo, Wo, Wwf, Gs^Fp, Ww, Wo, Wo, Wo
Wo, Wo, Wo, Wo, Wo, Wo, Wo, Wo, Wo, Wo, Wo, Wo, Ww, Gs^Fds, Mm, Hh, Gs, Gs, Ww, Wo, Ww, Ww, Ww, Wo, Wo, Wo, Wo, Wo, Wo, Wo, Wo, Wo, Wo, Wo, Wo, Wo, Wo, Wo, Wo, Ww, Wo, Wo, Wo, Wo, Wo, Wo, Wo, Wo, Wo, Wo, Wo, Wo, Wo, Wo, Wo, Wo, Wo, Wo, Wo, Wo, Wo, Wo, Wo, Wo, Wo, Wo, Wo, Wo, Wo, Wo, Wo, Ww, Hh, Gg^Vh, Wwf, Gg, Dd, Dd^Do, Dd, Dd, Gs^Fp, Gs^Vht, Wwf, Ww, Ww, Ww, Gg, Wwf, Wo, Wo, Wo, Wo
Wo, Wo, Wo, Wo, Wo, Wo, Wo, Wo, Wo, Wo, Wo, Wo, Ww, Gs^Fds, Mm, Gs, Gs, Wwf, Ww, Wo, Ww, Gs, Ww, Wo, Wo, Wo, Wo, Wo, Wo, Wo, Wo, Wo, Wo, Wo, Wo, Wo, Wo, Wo, Wo, Wo, Wo, Wo, Wo, Wo, Wo, Wo, Wo, Wo, Wo, Wo, Wo, Wo, Wo, Wo, Wo, Wo, Wo, Wo, Wo, Wo, Wo, Wo, Wo, Wo, Wo, Wo, Wo, Wo, Wo, Wo, Wo, Ww, Ww, Ww, Ww, Gs^Fp, Dd, Dd, Dd, Hh, Gs, Gs, Ww, Wwf, Wwf, Ww, Gg^Vh, Ww, Wo, Wo, Wo, Wo
Wo, Wo, Wo, Wo, Wo, Wo, Wo, Wo, Wo, Wo, Wo, Wo, Wo, Ww, Ww, Hh, Gg, Wwf, Gg, Ww, Wo, Ww, Wo, Wo, Wo, Wo, Wo, Wo, Wo, Wo, Wo, Wo, Wo, Wo, Wo, Wo, Wo, Wo, Wo, Wo, Wo, Wo, Wo, Wo, Wo, Wo, Wo, Wo, Wo, Wo, Wo, Wo, Wo, Wo, Wo, Wo, Wo, Wo, Wo, Wo, Wo, Wo, Wo, Wo, Wo, Wo, Wo, Wo, Wo, Wo, Wo, Wo, Wo, Wo, Ww, Gs, Gs, Gs, Gs, Gs, Ww, Ww, Wo, Ww, Ww, Hh, Ww, Ww, Wo, Wo, Wo, Wo
Wo, Wo, Wo, Wo, Wo, Wo, Wo, Wo, Wo, Wo, Wo, Wo, Wo, Wo, Wo, Ww, Ww, Gg, Ww, Ww, Wo, Wo, Wo, Wo, Wo, Wo, Wo, Wo, Wo, Wo, Wo, Wo, Wo, Wo, Wo, Wo, Wo, Wo, Wo, Wo, Wo, Wo, Wo, Wo, Wo, Wo, Wo, Wo, Wo, Wo, Wo, Wo, Wo, Wo, Wo, Wo, Wo, Wo, Wo, Wo, Wo, Wo, Wo, Wo, Wo, Wo, Wo, Wo, Wo, Wo, Wo, Wo, Wo, Wo, Wo, Ww, Ww, Ww, Ww, Ww, Wo, Wo, Wo, Wo, Wo, Ww, Wo, Wo, Wo, Wo, Wo, Wo
Wo, Wo, Wo, Wo, Wo, Wo, Wo, Wo, Wo, Wo, Wo, Wo, Wo, Wo, Wo, Wo, Wo, Ww, Wo, Wo, Wo, Wo, Wo, Wo, Wo, Wo, Wo, Wo, Wo, Wo, Wo, Wo, Wo, Wo, Wo, Wo, Wo, Wo, Wo, Wo, Wo, Wo, Wo, Wo, Wo, Wo, Wo, Wo, Wo, Wo, Wo, Wo, Wo, Wo, Wo, Wo, Wo, Wo, Wo, Wo, Wo, Wo, Wo, Wo, Wo, Wo, Wo, Wo, Wo, Wo, Wo, Wo, Wo, Wo, Wo, Wo, Wo, Wo, Wo, Wo, Wo, Wo, Wo, Wo, Wo, Wo, Wo, Wo, Wo, Wo, Wo, Wo
Wo, Wo, Aa, Wo, Aa, Wo, Wo, Wo, Wo, Wo, Aa, Aa, Wo, Wo, Wo, Wo, Wo, Wo, Wo, Wo, Wo, Wo, Wo, Wo, Aa, Aa, Aa, Wo, Wo, Wo, Wo, Wo, Wo, Wo, Wo, Wo, Wo, Wo, Wo, Wo, Wo, Wo, Wo, Wo, Aa, Aa, Aa, Aa, Aa, Wo, Aa, Wo, Wo, Wo, Aa, Wo, Aa, Wo, Aa, Wo, Wo, Wo, Wo, Wo, Aa, Wo, Aa, Wo, Wo, Wo, Wo, Wo, Wo, Wo, Wo, Wo, Wo, Wo, Wo, Wo, Wo, Wo, Wo, Wo, Wo, Wo, Wo, Wo, Wo, Wo, Wo, Wo
Aa, Aa, Aa, Aa, Aa, Aa, Aa, Aa, Aa, Aa, Aa, Aa, Aa, Aa, Aa, Wo, Aa, Wo, Aa, Wo, Aa, Aa, Aa, Wo, Aa, Aa, Aa, Aa, Aa, Wo, Aa, Wo, Aa, Aa, Aa, Aa, Aa, Wo, Wo, Wo, Wo, 8 Aa, Wo, 9 Aa, Aa, 6 Aa, Aa, 5 Aa, Aa, Aa, 4 Aa, Aa, Wo, Aa, 3 Aa, Aa, 1 Aa, Aa, 2 Aa, Aa, 7 Aa, Wo, Aa, Aa, Aa, Aa, Aa, Aa, Aa, Aa, Aa, Aa, Aa, Aa, Aa, Wo, Wo, Wo, Aa, Wo, Wo, Wo, Aa, Aa, Aa, Wo, Aa, Aa, Aa, Aa, Aa, Aa
Aa, Aa, Aa, Aa, Aa, Aa, Aa, Aa, Aa, Aa, Aa, Aa, Aa, Aa, Aa, Aa, Aa, Aa, Aa, Aa, Aa, Aa, Aa, Aa, Aa, Aa, Aa, Aa, Aa, Aa, Aa, Aa, Aa, Aa, Aa, Aa, Aa, Aa, Aa, Aa, Aa, Aa, Aa, Aa, Aa, Aa, Aa, Aa, Aa, Aa, Aa, Aa, Aa, Aa, Aa, Aa, Aa, Aa, Aa, Aa, Aa, Wo, Aa, Aa, Aa, Aa, Aa, Aa, Aa, Aa, Aa, Aa, Aa, Aa, Aa, Aa, Aa, Aa, Aa, Aa, Aa, Aa, Aa, Aa, Aa, Aa, Aa, Aa, Aa, Aa, Aa, Aa
