Hd, Hd, Dd, Dd, Dd, Dd, Dd, Hd, Dd, Dd, Dd, Dd, Dd, Hd, Dd, Dd, Dd, Hd, Dd, Dd, Dd, Hd, Dd, Dd, Dd, Dd, Dd, Dd, Dd, Dd, Dd, Dd, Dd, Dd, Dd, Dd, Dd, Dd, Dd, Dd, Rd, Dd, Dd, Dd, Dd, Dd, Dd, Dd, Ds, Ds, Ds, Ds, Ds, Ds, Ds, Ss, Ds, Ds, Ss, Ss, Ss, Ss, Ds, Ds, Ss, Ss, Ss, Ss, Ss, Ss, Ss, Ds, Ds, Dd, Dd, Dd, Dd, Dd, Dd, Dd, Dd, Hd, Dd, Dd^Dc, Dd, Hd, Dd, Hd, Dd, Dd, Dd, Hd, Hd, Md, Md, Md, Md, Md, Md, Md, Md, Md
Dd, Dd, Hd, Dd, Hd, Dd, Dd, Dd, Dd, Dd, Dd, Dd, Dd, Dd, Dd, Dd, Dd, Dd, Hd, Dd, Dd, Dd, Hd, Dd, Dd, Dd, Dd, Dd, Dd^Dc, Dd, Md, Dd, Dd^Do, Dd, Hd, Dd, Dd^Vda, Dd, Hd, Dd, Rd, Dd, Hd, Dd, Dd^Dc, Dd, Dd, Ds, Ds, Ds, Ss, Ds, Ds, Ds, Ds, Ds, Gs^Ft, Ds, Ss, Ss, Ds, Ss, Ds, Ds, Ss, Ss, Ss, Ss, Ds, Ss, Ss, Ds, Dd, Dd, Hd, Dd, Dd, Dd, Hd, Dd, Dd^Vdt, Hd, Dd, Dd, Dd, Hd, Ds, Hd, Dd, Dd, Dd, Hd, Md, Md, Md, Md, Md, Md, Md, Md, Md^Xm, Md^Xm
Hd, Hd, Dd, Dd, Hd, Dd, Hd, Dd, Hd, Rr^Vd, Dd, Dd, Hd, Dd, Hd, Md, Hd, Dd, Dd, Dd, Dd^Vdt, Dd, Dd, Dd, Dd, Hd, Dd, Dd, Dd, Hd, Dd, Md, Dd, Dd, Dd, Dd, Dd, Rd, Rd, Rd, Dd, Dd^Vda, Rd, Rd, Rd, Rd, Dd^Vda, Dd, Ds, Ds, Ds, Ss, Ss, Ss, Ds, Ss, Gs^Ft, Gs^Ft, Ss, Ds, Ss, Ss, Ss, Ss, Gs^Ft, Gs^Ft, Gs^Ft, Ss, Ds, Ds, Gs^Ft, Ds, Ds, Hd, Dd, Dd, Dd, Hd, Ds, Rd, Ds, Dd, Dd, Hd, Dd, Dd, Hd, Ds, Dd^Dc, Md, Dd, Hd, Md, Md, Md, Md, Md, Rd, Rr^Vd, Md^Xm, Md^Xm, Md^Xm
Hd, Dd, Hd, Dd, Dd, Dd, Dd, Dd, Dd, Rd, Dd, Dd, Dd, Dd, Dd, Md, Md, Hd, Dd, Dd, Rd, Dd, Hd, Dd, Dd^Vdt, Dd, Dd, Dd, Dd, Dd, Dd, Dd, Gs, Gs, Gs, Gs, Hd, Dd, Rd, Dd, Dd, Dd, Dd^Do, Dd, Dd, Dd, Gs, Dd, Ds, Ss, Ss, Gs^Ft, Ds, Gs^Ft, Ds, Ss, Ss, Ss, Gs^Ft, Ss, Ds, Ss^Vhs, Gs, Ss, Ss, Ss, Ss, Ss, Gs^Ft, Gs^Ft, Ss, Gs^Ft, Gs, Ds, Ds, Dd, Ds, Dd, Ds, Dd, Dd, Ds, Dd, Ds, Dd^Vdt, Dd^Dr, Dd, Dd, Dd, Dd, Dd, Hd, Hd, Hd, Hd, Hd, Hd, Hd, Hd, Md^Xm, Md^Xm, Md^Xm
Dd, Dd, Hd, Dd, Dd, Hd, Dd, Hd, Dd, Dd, Hd, Dd, Dd, Dd^Dc, Dd, Hd, Dd, Dd, Dd, Dd, Rd, Dd, Dd, Dd, Rd, Hd, Dd, Dd, Dd, Dd, Dd, Gs, Gg, Gs, Gg, Gs, Gg, Dd, Dd^Vda, Dd, Hd, Md, Dd, Hd, Dd, Dd, Dd, Gs, Gs, Ss, Ss, Ds, Ss, Ds, Gs, Ss^Vhs, Ss, Gs, Ss, Ss, Ss, Ss, Ss, Ds, Ss, Gs^Ft, Rd, Ds, Ds, Ss, Gs^Ft, Gs^Ft, Gs^Ft, Gs, Gs, Ds, Ds, Ds, Dd^Vdt, Dd, Dd, Hd, Dd, Rd, Ds, Dd, Dd, Hd, Ds, Hd, Ds, Dd, Rd, Rr^Vd, Hd, Hd, Md, Md, Md^Xm, Md^Xm, Md^Xm, Md^Xm
Hd, Hd, Dd, Dd, Dd, Rr^Vd, Rd, Dd, Hd, Dd, Dd, Dd, Dd, Hd, Dd, Dd, Dd, Hd, Dd, Dd, Dd, Rd, Dd, Hd, Dd, Rd, Rd, Dd, Gs, Gs, Gs, Gs, Mm, Gg, Gg, Gg, Gg, Rd, Hd, Dd, Dd, Dd, Gs, Dd, Dd^Vda, Gs, Gs, Gs, Gs, Gs, Gs, Ss, Gs^Ft, Ss, Gs, Ss, Gs^Ft, Ss, Ds, Ss, Gs^Ft, Gs, Ss, Ss, Ds, Ss, Ss, Gs^Ft, Gs^Ft, Gs^Ft, Gs, Gg^Ve, Gs, Gs^Ft, Ss, Gs^Ft, Gs, Rd, Rd, Ds, Dd, Dd, Gs^Ft, Gs^Ft, Ww, Ds, Dd, Dd, Hd, Ds, Dd, Dd, Dd, Hd, Hd, Md, Md^Xm, Md^Xm, Md^Xm, Md^Xm, Md^Xm, Md^Xm
Hd, Hd, Dd, Dd^Dc, Dd, Dd, Dd, Dd, Dd, Dd, Dd, Dd, Dd, Dd, Dd, Hd, Dd, Dd, Dd^Do, Hd, Dd, Rd, Gg, Dd, Gg, Gg, Gg, Rd, Gg, Gg, Mm, Mm^Xm, Mm^Xm, Mm, Hh, Gg, Gg, Rd, Hd, Hd, Dd, Dd, Gs, Dd, Dd, Hd, Gg, Gg, Dd, Gs, Gs, Ds, Ss, Ss, Ds, Ss, Gs, Ss, Ss, Gs^Ft, Gs^Ft, Ss, Ss, Ds, Ds, Ss, Gs, Gs, Gs^Ft, Ss, Gs^Ft, Gs^Ft, Gs^Ft, Ds, Gs, Gs^Ft, Ds, Gs, Ds, Ds, Dd, Dd, Gg, Dd^Do, Dd, Ds, Hd, Dd, Md, Dd, Dd, Hd, Dd, Dd, Dd, Md, Md, Md, Md, Md^Xm, Md, Md^Xm
Md, Hd, Hd, Dd, Dd^Do, Hd, Dd, Dd, Hd, Dd, Dd, Dd, Hd, Dd, Hd, Dd, Dd, Gs, Dd^Vda, Dd, Rd, Rd, Gg, Gg, Gg, Gg, Gg, Rd, Rd, Mm, Mm, Mm^Xm, Mm^Xm, Mm, Hh, Gg, Gg, Rd, Rd, Hd, Dd, Gs, Gs, Gs, Gs, Gs, Gg, Gg, Gg, Dd, Dd, Gs, Gs, Ss, Gs^Ft, Gs, Ss, Ss, Ss, Ss, Rd, Ds, Ss, Gs^Ft, Ss, Gs^Ft, Gs^Ft, Gs^Ft, Hh, Ds, Gs^Ft, Gs, Gs, Gs^Ft, Gs^Ft, Rd, Rd, Gs, Gs, Ds, Dd, Dd, Dd, Gs^Ft, Dd, Dd, Dd, Md, Md, Dd^Do, Dd, Dd, Hd, Dd, Dd, Dd, Hd, Md, Md, Md, Md, Md
Md, Md, Md, Hd, Dd, Dd, Hd, Dd, Dd, Dd, Dd, Md, Md^Xm, Md, Dd, Dd, Hd, Hd, Dd, Rd, Gg, Rd, Rd, Hh, Hh, Gg, Gg, Gg, Rd, Hh, Hh, Mm^Xm, Mm^Xm, Mm^Xm, Mm^Xm, Hh, Hh, Gg, Gg, Rd, Rd, Gs, Gg, Ww, Ww, Dd^Do, Dd, Gg, Gg^Vh, Dd, Gg, Gs, Gs, Ds, Ds, Ds, Ss, Gs^Ft, Ss, Rd, Ds, Ss, Gs^Ft, Ds, Ss, Ss, Gg^Ve, Gs, Gs^Ft, Gs^Ft, Ss, Ss, Gs^Ft, Gs^Ft, Ss, Gs^Ft, Gs, Gs^Ft, Gs, Ds, Ds, Dd, Hd, Dd, Dd, Hd, Dd, Hd, Dd, Hd, Hd, Dd, Dd, Dd, Md, Dd, Dd, Hd, Hd, Hd, Hd, Hd
Md^Xm, Md^Xm, Md^Xm, Hd, Hd, Hd, Hd, Dd, Hd, Dd, Hd, Md, Md, Hd, Hd, Dd, Dd, Dd, Rd, Rd, Gg, Gg, Rd, Hh, Gg, Gg, Gg, Gg, Gg, Gg^Vc, Mm, Hh, Mm^Xm, 1 Mm, Mm^Xm, Mm, Mm, Hh, Gg, Gg, Rd, Gg, Gg, Ww, Wo, Dd, Gg, Gg, Gg, Gg, Gg, Gg, Gg^Vh, Gs, Gg, Ss, Ss, Ss, Gs, Ds, Gs^Ft, Ss, Ss, Rd, Rd, Gs^Ft, Gs^Ft, Gs^Ft, Gs^Ft, Gs^Ft, Gs^Ft, Ss, Ds, Ss, Gs, Gs^Ft, Gg^Ve, Gs^Ft, Hh, Gs, Ds, Dd, Dd, Dd, Hd, Ds, Dd, Hd, Ds, Dd, Dd, Dd, Dd, Dd, Dd, Dd, Dd, Ds, Wo, Wo, Wo, Ds
Md, Md^Xm, Md, Md^Xm, Md^Xm, Md^Xm, Hd, Dd, Dd, Dd, Dd, Md, Dd, Dd, Dd, Dd, Hd, Dd, Gs, Rd, Gg, Gg, Re^Gvs, Rd, Rd, Gg, Gg, Hh, Mm, Mm, Mm^Xm, Hh, Mm^Xm, Mm, 2 Mm, Mm^Xm, Mm^Xm, Mm, Hh, Gg^Vh, Rd, Gg, Gg, Gg, Gg, Ww, Wo, Gg, Gg, Gg, Gg, Gg, Gg, Gg, Wo, Wo, Gs, Gs, Gs, Gs, Gg, Gs, Gs, Gs^Ft, Gs, Gs, Gs^Ft, Ss, Ds, Gs^Ft, Gs^Ft, Ss, Gs^Ft, Gs^Ft, Gs^Ft, Gs, Gs^Ft, Rp, Gs, Gs, Hd, Dd, Dd, Dd, Dd, Dd, Dd, Dd, Dd, Dd, Dd, Dd^Dc, Dd, Hd, Dd, Hd, Dd, Ds, Wo, Wo, Ds, Ds
Hd, Md, Hd, Hd, Gs^Ft, Hd, Dd, Dd, Md, Hd, Dd, Hd, Dd, Md, Dd, Dd, Dd, Dd, Gs, Gg^Vh, Gg, Re^Gvs, Re^Gvs, Gg, Rd, Re^Gvs, Gg, Hh, Mm, Mm, Mm, Mm^Xm, 6 Mm, Mm^Xm, Mm, Mm^Xm, Mm^Xm, Mm, Mm, Hh, Rd, Gg, Gg, Hh, Gg, Gg, Gg, Wo, Gg, Gg, Gg^Vh, Gg, Hh^Fp, Gg, Wo^Bw\, Hh, Gg, Gg^Vh, Gg, Gs^Ft, Gg, Hh, Gs, Gs, Gs, Gs^Ft, Gs^Ft, Gs^Ft, Gs^Ft, Rd, Gs^Ft, Rd, Gs^Ft, Gs^Ft, Hh, Gs^Ft, Rp, Rp, Gs^Ft, Gs, Gs, Ds, Dd, Hd, Dd, Dd, Dd, Hd^Dr, Dd^Vda, Dd, Dd, Dd, Dd, Hd, Dd, Dd, Dd, Wo, Wo, Wo, Ds, Ds
Dd, Hd, Dd, Dd, Gs^Ft, Dd^Do, Dd, Hd, Hd, Dd, Dd, Dd, Dd, Hd, Dd, Dd, Gs, Gs, Gs, Gg, Gg, Gg, Gg, Gg, Gg^Vh, Re^Gvs, Gg, Gg, Gg^Vc, Mm, Mm, Mm^Xm, 5 Mm, Mm, Mm, 3 Mm, Mm^Xm, Mm, Hh, Hh, Rd, Gg, Hh, Gg, Gg, Gs^Fp, Gg, Wo, Wo, Gg, Gg, Hh, Wo, Ww, Re^Gvs, Gg, Gs, Hh, Gg, Gs, Gs, Gg, Gs^Ft, Hh, Ss, Gs, Gs, Gs, Gs^Ft, Gs^Ft, Gg^Ve, Gs^Ft, Gs^Ft, Hh, Gs^Ft, Gs, Rp, Hh, Gg, Gg, Wo, Ds, Dd, Dd, Dd, Hd, Hd, Dd, Rd, Dd, Hd, Dd, Hd, Dd, Dd, Dd, Dd, Wo, Wo, Wo, Wo, Ds
Dd, Dd, Dd, Dd^Vda, Rd, Rd, Dd, Dd, Dd, Dd, Dd^Vda, Hd, Dd, Dd, Dd, Dd, Gs, Gs, Ww, Gs, Ww, Gs^Fmf, Gg, Gg, Gg, Gg, Hh, Gg, Hh, Mm, Mm^Xm, Mm^Xm, Mm^Xm, 4 Mm, Mm^Xm, Mm^Xm, Mm, Mm, Hh, Gg, Rd, Gg, Gg, Gg, Gs^Fp, Gg, Gs^Fmw, Gg, Ww, Gg, Gg, Hh^Fp, Wo, Re^Gvs, Gs^Fp, Gg, Hh, Gs, Hh^Fdw, Gg, Gg, Gg, Hh, Ss, Wwf, Gs, Gg, Gs, Gs^Ft, Gs, Gs, Gs^Ft, Gs, Gs^Ft, Gs, Gs^Ft, Rp, Gg, Ww, Gg, Wo, Ds, Ds, Dd, Dd, Dd, Dd, Dd, Dd, Dd, Dd, Hd, Dd, Dd, Rd, Hd, Wo, Wo, Ds, Wo, Wo, Wo
Dd, Hd, Dd, Dd, Dd, Dd, Dd, Hd, Dd, Rd, Dd, Rd, Dd, Dd, Gs, Gs, Gs, Ww, Ww, Ww, Ww, Gs^Fmf, Gg, Gg, Gg, Gg, Hh, Hh, Mm, Mm^Xm, Mm^Xm, Mm^Xm, Mm, Mm^Xm, Mm, Mm^Xm, Ww, Hh, Hh, Gg^Vh, Gg, Rd, Rd, Hh^Fp, Rd, Gg^Ve, Hh, Gg, Gg, Ww, Gg, Gg, Wo, Re^Gvs, Hh, Gs^Fp, Hh, Gs, Gg, Hh, Gg, Gg, Gs, Gs, Gg, Hh, Gg, Gg, Gg, Gs, Hh, Hh, Hh, Gs, Gg, Gs, Ww, Ww^Bw\, Rr, Ww, Ww, Ww, Ww, Ds, Dd, Dd, Hd, Dd, Hd, Dd, Hd, Ds, Dd, Dd, Dd, Dd^Vda, Wo, Wo, Wo, Wo, Wo, Wo
Dd, Dd, Hd, Dd, Dd, Hd, Dd, Dd, Dd, Dd, Hd, Rd, Rd, Rd, Gs, Gs, Rd, Gs, Gg, Ww, Gg, Gg, Gg, Gg, Gg, Gg, Gs^Fmf, Hh, Mm, Mm, Mm, Mm, Mm, Mm, Mm^Xm, Ww, Ww, Hh, Gg, Gg, Gg, Gg, Rd, Rd, Gs^Fp, Gg, Gg^Fet, Gs^Fp, Gg, Ww, Ww, Wwf, Re^Gvs, Hh, Gg, Gg^Vc, Gg, Gg, Rd, Gg, Re, Re, Re, Gg^Vh, Rp, Gg, Gg, Re^Gvs, Re^Gvs, Hh, Hh, Hh, Mm^Xm, Hh, Gg, Gg, Wo, Hh, Rr, Gg, Gg^Vh, Gg, Gg, Ds, Dd, Hd, Dd, Dd, Dd, Dd^Do, Gs^Ft, Dd, Hd, Dd, Dd, Ds, Ds, Wo, Wo, Wo, Wo, Wo
Hd, Dd, Dd, Dd, Dd, Dd, Dd^Dc, Dd^Do, Hd, Dd, Dd, Dd, Gs, Rd, Rd, Rd, Gg^Vh, Gg, Re^Gvs, Ww, Gg^Vh, Gg, Gg, Gg, Gg, Gg, Gg, Hh, Hh, Mm, Hh, Hh, Mm, Ww, Mm^Xm, Mm, Mm, Ww, Ww, Gs^Fmw, Gs^Fmw, Gs^Fp, Gg^Ve, Gs^Fp, Gs^Fp, Gs^Fp, Gs^Fp, Gs^Fp, Hh, Ww, Hh, Gg, Gg, Hh, Rd, Rd, Rd, Rd, Hh, Rd, Gg, Gg, Gg, Gs^Fp, Gg, Rp, Rp, Re^Gvs, Hh, Hh, Mm^Xm, Mm^Xm, Wo, Hh, Wo, Wo, Gg, Gg, Gg, Rr, Gg, Gg, Hh, Ds, Dd, Hd, Dd, Rd, Dd, Dd, Hd, Dd, Rd, Hd, Dd, Dd, Ds, Wo, Wo, Wo, Dd, Wo
Dd, Dd, Dd, Hd, Dd, Dd, Dd, Dd, Dd, Dd, Dd, Gs, Gs, Gg, Gg, Gg, Gg, Gg, Re^Gvs, Ww, Ww, Gg, Gg, Gg, Gg, Gg, Gg, Gg, Gg, Hh, Gg, Mm, Mm^Xm, Mm^Xm, Mm^Xm, Mm, Hh, Hh, Ww, Ww, Gg, Gg, Wo, Wo, Ww, Gg, Hh, Hh, Ww, Ww, Hh, Gs^Fp, Rd, Rd, Hh, Gg, Gg^Vc, Hh, Hh, Gg, Gs^Fp, Gg, Hh, Gg, Hh, Gg, Gg, Gg^Vh, Hh, Mm^Xm, Mm, Mm, Hh, Wo, Gg^Vh, Gg, Gg, Gg, Gs, Rr, Re^Gvs, Hh, Hh, Gs, Ds, Dd, Rd, Dd^Vda, Hd, Hd, Md, Hd, Dd^Vda, Dd, Hd, Dd, Dd, Ds, Wo, Wo, Wo, Wo
Dd, Hd, Dd, Dd, Dd^Vda, Dd, Dd, Hd, Dd, Dd, Dd, Gs, Hh, Hh, Gg, Gg, Dd, Gg, Re^Gvs, Re^Gvs, Wo, Gg, Gs^Fmf, Gg, Gs^Fmf, Gg, Gs^Fdf, Gg, Gg, Gg, Gg, Mm, Gs, Hh, Gs, Hh, Gg, Gg, Wo, Wo, Ss, Gg, Ww, Wo, Gg, Ww, Ww, Ww, Mm, Mm, Hh, Gs^Fp, Rd, Re^Gvs, Re^Gvs, Hh, Gg, Gg, Re^Gvs, Re^Gvs, Gg, Hh, Hh, Hh, Gg, Gg, Hh, Hh, Mm, Mm^Xm, Mm, Hh, Gg, Gg, Gg, Gg, Gs^Fp, Gs^Fp, Gs, Rr, Re^Gvs, Re^Gvs, Hh, Gs, Ds, Hd, Hd, Dd, Hd, Md, Md, Hd, Dd, Dd, Dd, Dd, Dd, Rd, Ds, Wo, Wo, Wo
Hd, Dd, Dd, Dd, Gs^Ft, Rd, Dd, Dd, Gs, Dd, Gs, Gs, Gg, Gg, Gg, Dd, Dd, Gg, Gg, Hh, Wo, Gs^Fdf, Gg, Gg, Gg, Hh, Hh, Gs^Fdf, Gs^Fmf, Gg, Gg, Gg, Gs, Gs, Gs, Gg, Gg, Gg, Wo, Ss, Ss, Ww, Wo, Ww, Gg, Ww, Ww, Hh, Hh, Hh, Gg, Gg, Rd, Re^Gvs, Gg, Hh, Gg, Hh, Hh, Gg, Gg, Gg^Vc, Gg, Gg, Hh^Fdw, Gg, Hh, Hh, Mm^Xm, Mm^Xm, Hh, Hh, Gg, Gg, Gg, Gg, Re^Gvs, Re^Gvs, Re^Gvs, Rr, Gg, Re^Gvs, Gg^Vh, Gs, Gs, Ds, Dd, Dd, Hd, Hd, Hd, Ds, Ds, Dd, Dd, Dd, Ds, Dd^Vda, Wo, Wo, Wo, Ds
Dd, Dd, Ww, Ww, Gs^Ft, Rd, Rd, Rd, Rd, Gs, Gs, Gs, Gg, Gg, Gg, Dd, Gg, Dd, Gg, Gg, Ww, Gg, Gg^Ve, Gs^Fdf, Gs^Fmf, Gs^Fdf, Gs^Fmf, Gs^Fmf, Gs^Fdf, Gs, Gs, Gs, Ss, Dd, Dd, Ss, Ww, Ww, Ww, Ww, Ww, Wo, Wo, Ww, Wo, Wo, Ss, Gg, Gg, Gg, Gg, Rd, Gg, Gg^Vc, Hh, Gg, Gg, Gs^Fdw, Hh, Hh, Re^Gvs, Re^Gvs, Gg, Gg, Hh^Fdw, Hh, Mm, Mm, Mm^Xm, Mm, Hh, Gg, Gg, Hh, Gg, Gg, Gg, Re^Gvs, Rr, Rr, Gg, Gg, Gs, Gs, Hh, Ds, Ds, Dd, Dd, Hd, Dd, Ds, Hd, Dd, Hd, Dd, Ds, Wo, Wo, Wo, Wo, Ds
Dd, Dd, Ww, Dd^Do, Gs^Ft, Gs^Ft, Gg, Gg, Gg, Rd, Gg, Gg, Gg, Gg^Vh, Re^Gvs, Gg, Gg, Gg, Gg, Ww, Re, Gg, Gs^Fmf, Gs^Fdf, Gs^Fdf, Gs^Fmf, Gg, Gg^Ve, Gg, Gs, Dd, Ss, Ww, Ww, Ss, Ss, Ss, Wo, Wo, Wo, Wwr, Wo, Ww, Ww, Ww, Wo, Ww, Gg, Gg, Gg, Re, Re, Gg, Hh, Gg, Gg, Gs^Fp, Hh, Gg, Gg, Gs^Fp, Re^Gvs, Hh, Hh^Fdw, Hh^Fdw, Mm, Mm, Mm^Xm, Mm, Hh, Gg^Vh, Gg, Rp, Gg, Gg, Gg^Vh, Rp, Rr, Rr, Gs^Fp, Gg, Re^Gvs, Re^Gvs, Gs, Gs, Gs, Ds, Hd, Dd, Hd, Rd, Dd^Vda, Dd, Dd, Ds, Dd, Ds, Wo, Wo, Wo, Wo, Wo
Ww, Ww, Ww, Ww, Dd, Gs, Gg, Gg, Gg^Vh, Rd, Rd, Gg, Hh, Hh, Re^Gvs, Re^Gvs, Gg, Gg, Gg, Wo, Re, Gg, Gg, Gg, Gg, Gg, Gg, Gs^Fdf, Hh, Gs, Gs, Ss, Ss, Ww, Dd, Ss, Ss, Wo, Wo, Wo, Gs^Fdw, Ww, Wo, Ww^Vm, Ww, Ww, Gs^Fdw, Ww, Gg, Re, Gg, Gg, Gg, Gg, Gg, Hh, Ww, Gs^Fp, Hh, Gg, Gs^Fp, Gg, Gg^Vc, Gg, Hh, Mm, Mm^Xm, Mm^Xm, Hh, Hh, Gg, Rp, Re^Gvs, Rp, Rp, Rp, Ww, Re^Gvs, Re^Gvs, Rr, Gg^Vh, Re^Gvs, Gg, Gg, Gg, Gg, Gs, Ds, Ds, Dd, Dd, Hd, Dd, Ds, Ww, Ds, Ds, Ds, Wo, Wo, Wo, Wo
Ww, Ww, Gs, Dd, Gs, Gs, Gg, Gg, Gg, Gg, Rd, Gg, Gg, Gg, Gg, Re^Gvs, Gg, Gg, Wo, Wo, Gg, Re, Gg, Gg, Hh, Hh, Mm, Hh, Mm, Hh, Hh, Ww, Gs, Dd, Gg, Gg, Gg, Wo, Ss, Wo, Ww, Wo, Wo, Wwf, Wo, Gs^Fdw, Wo, Wo, Gg, Re, Gg, Gg, Gs^Fdw, Hh, Hh, Gs^Fp, Ww, Ww, Gg, Gg, Re^Gvs, Gg, Gg, Hh, Hh, Mm, Mm^Xm, Hh, Gg, Gg, Hh, Re^Gvs, Gs^Fp, Gg, Re^Gvs, Re^Gvs, Ww, Ww, Rr, Rr, Gg, Gg, Gg, Hh, Gg, Gs, Gs, Gs, Gs, Ds, Hd, Ds, Gs^Ft, Gs^Ft, Dd^Do, Ww, Ds, Ds, Wo, Wo, Wo, Wo
Ww, Ww, Gs^Fp, Gs, Gs, Hh, Hh, Hh, Gg, Gg, Rd, Gg, Dd, Dd, Gg, Gg, Gg, Wo, Gs, Gg, Gg, Re, Re, Gg, Hh, Mm, Mm^Xm, Mm, Mm^Xm, Mm, Mm, Gs, Gs, Gs, Hh, Gg, Ww, Ww, Ss, Ss, Wo, Ww, Wwf, Ww, Wo, Wo, Wo, Gg, Gg, Re, Re, Gg, Gg, Hh, Gg, Gg, Gg, Gs^Fp, Gg, Re^Gvs, Re^Gvs, Gs^Fmw, Gg, Gg, Hh, Hh, Mm, Mm, Gg, Hh, Hh, Gg, Gg, Gg, Gg, Re^Gvs, Hh, Gs, Rr, Hh, Re^Gvs, Gg, Gg, Gg, Gs, Gg, Gs, Gs, Gs, Ds, Dd, Dd, Dd, Gs^Ft, Gs, Ww, Ds, Wo, Wo, Wo, Wo, Wo
Gs^Fp, Gs^Fp, Gs, Gs, Hh, Hh, Gs^Fp, Hh, Gg, Gg, Rd, Gg, Dd, Gg, Gs^Fp, Gs^Fp, Wo, Wo, Gs, Gs, Gs, Gg^Vh, Re, Hh, Mm, Mm, Mm, Mm^Xm, Mm^Xm, Mm^Xm, Mm, Hh^Fp, Mm, Mm, Mm, Hh, Ww, Wwf, Ww, Wo, Wo, Ww^Vm, Ww, Wo, Gg, Wo, Wo, Wo, Gs^Fp, Gs^Fp, Re, Gs^Fp, Re^Gvs, Re^Gvs, Gg, Hh, Gg, Gg, Hh, Gg, Gg, Gg, Gg, Gg, Hh, Mm, Mm, Mm, Hh, Gg, Gg, Gg, Gg, Gg, Re^Gvs, Mm, Hh, Gg, Rr, Re^Gvs, Re^Gvs, Gg, Gs^Fp, Gg, Hh, Hh, Gs, Gs, Gs, Gs, Gs, Ds, Ds, Ds, Ds, Ds, Ds, Wo, Wo, Wo, Wo, Wo
Gg^Fet, Gs^Fp, Gs, Gg, Gg, Hh, Gg, Gg, Rd, Rd, Gg, Gg, Gg, Gg, Mm, Gs^Fp, Wo, Gg^Vh, Gg, Gs, Gs, Gg, Gg, Re, Hh, Mm, Hh, Mm, Mm^Xm, Mm^Xm, Mm^Xm, Mm, Gg, Mm, Mm, Hh^Fms, Wwr, Ww, Gg, Wo, Ww, Ww, Ww, Wo, Gs^Fms, Gg, Gg, Gg^Vh, Gg, Gs^Fp, Re, Gg, Gg, Re^Gvs, Gg, Gg, Gg, Gg, Gg, Hh, Gg, Hh, Gs^Fmw, Gs^Fmw, Gg, Hh, Mm, Mm^Xm, Mm, Gg^Vh, Gg, Gg, Gg, Re^Gvs, Re^Gvs, Re^Gvs, Gg, Gg, Rp, Gg, Gg, Gg, Gg, Gg, Hh, Hh, Gs, Gs, Gg, Gs, Gs, Gs, Gs, Ds, Gs, Ds, Ds, Ds, Wo, Wo, Wo, Wo
Gs^Fp, Hh, Hh, Gg, Gg, Gg, Gg, Gg, Rd, Gg^Vh, Gg, Gg, Gg, Mm, Mm, Wo, Gg, Gg, Gg, Gs, Gs, Gs, Gg, Re, Gg, Hh, Gs^Fdf, Hh, Hh, Mm^Xm, Mm, Mm^Xm, Mm, Gg, Mm^Xm, Hh, Hh, Gg, Gg, Gg, Gg, Gg, Wwf, Gg, Gg, Gg, Gg, Gg, Hh, Gg, Gg, Re, Gg^Vh, Gg, Gg, Gs^Fp, Gg, Hh, Gg, Gg, Gs^Fmw, Gg, Mm, Gs^Fmw, Gg, Gg, Hh, Mm^Xm, Mm^Xm, Hh, Gg, Re^Gvs, Re^Gvs, Gg, Gg, Gg, Gg, Rp, Gg, Gg, Gg, Gg, Gg, Gg, Gs, Gs, Re^Gvs, Re^Gvs, Re^Gvs, Gg, Gs, Gs, Gs, Gs, Re^Gvs, Gs, Gg, Gg, Wo, Wo, Wo, Wo
Gs^Fp, Gs^Fp, Gs^Fp, Gg, Gs^Fp, Gg, Gg, Gg, Rd, Re^Gvs, Re^Gvs, Re^Gvs, Re^Gvs, Hh, Ww, Wo, Gs^Fmf, Gg, Re, Gg, Gs^Fdf, Gs, Re, Re, Gg^Vh, Gg, Ww, Gg, Mm, Mm, Mm^Xm, Mm^Xm, Mm^Xm, Mm, Mm, Mm, Mm, Hh^Fp, Gg, Gg, Gg, Gg, Gg, Wo, Wo, Gg, Gg, Gg, Rp, Gg, Rp, Rp, Rp, Gg, Hh, Gg, Gg, Gg, Gg, Gg, Gs^Fmw, Mm, Mm, Mm, Gg^Vh, Gg, Gg, Hh, Mm^Xm, Mm, Hh, Re^Gvs, Re^Gvs, Gg, Gg, Gg, Gg, Rp, Rp, Gg, Gg, Gg, Gg^Vh, Gg, Gg, Gs, Re^Gvs, Re^Gvs, Gg, Gg, Hh, Gs, Gs, Re^Gvs, Re^Gvs, Gg, Rd, Gg^Vh, Wo, Wo, Wo, Wo
Gs^Fp, Gg^Fet, Hh, Gs^Fp, Gs^Fp, Gg, Gg, Gg, Gg, Rd, Re^Gvs, Re^Gvs, Gg, Gg, Wwf, Gs^Fmf, Gs^Fmf, Re, Gg^Vh, Re, Re, Re, Gs, Gs, Gg, Gg, Ww, Hh, Mm, Mm^Xm, Mm, Mm^Xm, Mm^Xm, Mm, Mm, Mm, Hh, Hh, Gg, Gg, Gg, Gg, Gg, Wo, Gg^Vh, Gg, Rp, Rp, Gg, Rp, Gs^Fms, Gg, Gg, Rp, Rp, Gg, Gg, Gg, Gg, Gs^Fmw, Gg, Hh, Hh, Hh, Gg, Rp, Gg, Hh, Mm, Mm^Xm, Mm, Hh, Gg, Gg, Hh, Hh, Hh, Gg^Vh, Gg, Rp, Rp, Rp, Gg, Gg, Gg, Gg, Gg, Gg, Gg^Vh, Hh, Gs^Fp, Gs, Rd, Gs, Rd, Rd, Gg, Wo, Wo, Wo, Wo, Wo
Gs^Fp, Gs^Fp, Gs^Fp, Gg^Ve, Rp, Rp, Gg, Hh, Gg, Rd, Rd, Re^Gvs, Gg, Wo, Hh, Hh, Gg, Gg, Gg, Gs, Gs, Gs, Gs, Gs, Gs, Ww, Ww, Hh, Mm, Mm^Xm, Mm^Xm, Mm^Xm, Mm^Xm, Mm^Xm, Mm, Hh, Gg, Gg, Gs^Fp, Gs^Fp, Gg, Gg, Gg, Gg, Gg, Rp, Gs^Fms, Gg, Gg, Gg, Re^Gvs, Gg, Hh, Gg, Gg, Gg^Vh, Gg, Gg, Re^Gvs, Gg, Gg, Gg, Gg, Gg, Gg, Rp, Rp, Hh, Hh, Mm^Xm, Mm^Xm, Ww, Ww, Gg, Hh, Hh, Gg, Gg, Wo, Gg, Re, Rp, Rd, Rd, Ww, Gg, Rd, Rd, Gg, Rd, Rd, Rd, Gg, Rd, Gg, Gg, Re^Gvs, Wo, Wo, Wo, Wo, Wo
Gs^Fp, Gs^Fp, Gg, Gg, Rp, Gg, Gg, Gg, Gg, Gs^Fp, Gs^Fp, Rd, Gg, Wo, Wo, Hh, Hh, Gg, Gg, Gg, Gs, Gs, Gs, Re^Gvs, Re^Gvs, Gg, Hh, Hh, Mm^Xm, Mm^Xm, Mm^Xm, Hh, Mm, Mm, Gg, Hh, Gg, Gs^Fp, Gs^Fp, Gs^Fp, Gs^Fp, Gg, Gg, Gg, Hh, Rp, Rp, Gg, Gg, Re^Gvs, Re^Gvs, Gg, Gg, Gg, Gg, Gg, Gg, Gg, Re^Gvs, Re^Gvs, Gg, Gg, Gg, Gg, Gg, Hh, Rp, Gg, Gg^Vh, Hh, Hh, Hh, Gg, Ww, Wo, Wo, Wo, Wo, Re^Gvs, Wo, Ww, Ww^Bw|, Wwf, Ww, Wo, Ww, Gg, Gg, Gg, Gg, Gg, Gs^Fp, Gg, Rd, Rd, Hh, Gg, Re^Gvs, Wo, Wo, Wo, Wo
Gs^Fp, Gs^Fp, Gs^Fp, Gg, Rp, Gs^Fp, Gs^Fp, Gs^Fp, Hh, Gg^Fet, Hh, Rd, Gg, Gg, Wo, Hh, Gg^Vh, Gg, Gg, Gg, Gg, Gs, Gg^Vh, Re^Gvs, Gg, Gg, Hh, Mm, Hh^Fms, Mm, Hh, Hh, Hh, Gg, Gg, Gg, Gg, Gg, Gg, Gs^Fp, Gg, Gg, Hh, Hh, Mm, Hh, Hh, Gg^Vh, Gg, Re^Gvs, Gg, Gg^Vh, Gg, Gs^Fms, Gg, Gg, Gg, Re^Gvs, Re^Gvs, Re^Gvs, Gs^Fms, Gg, Gg, Gg^Vh, Hh, Gg, Gg, Rp, Gg, Gg, Gg, Gg, Gg, Gg, Gg, Gg, Re^Gvs, Re^Gvs, Hh, Rd, Rp, Rp, Gg, Ww, Ww, Ww, Gg, Gg, Hh, Re^Gvs, Re^Gvs, Gg^Vh, Gg, Gg, Rd, Gs^Fp, Gg, Gg^Vh, Wo, Wo, Wo, Wo
Gs^Fp, Hh, Gg^Fet, Rp, Gg, Gg^Ve, Hh, Hh, Mm, Hh, Hh, Rd, Rd, Gg, Gg, Wo, Wo, Gg, Re^Gvs, Gs^Fp, Re^Gvs, Gg, Gg, Gg, Rd, Gg, Rd, Hh^Fms, Gg, Hh, Gg, Hh, Hh, Gg, Gg, Gg, Hh, Gg, Gg, Gg, Gg, Hh, Mm, Mm^Xm, Mm^Xm, Mm^Xm, Re^Gvs, Gg, Gg, Hh, Gg, Gg, Gg, Gg, Gg, Gg, Gs^Fms, Gg, Gg, Gg, Gg, Gg, Gg, Gg, Gg, Gg, Gg, Rp, Gg, Gg, Gg, Gg, Gg, Gg, Gs^Fms, Gs^Fms, Gg, Re^Gvs, Gg^Vh, Gg, Rp, Gg, Gg, Gg, Gg, Ww, Gg, Gg, Re^Gvs, Re^Gvs, Re^Gvs, Gg, Gg, Hh, Rd, Gg, Gg, Wo, Wo, Wo, Gg, Wo
Gs^Fp, Gs^Fp, Gs^Fp, Rp, Gg, Gs^Fp, Hh, Mm, Mm^Xm, Mm, Mm, Hh, Hh, Rd, Gg, Gs^Fp, Wo, Re^Gvs, Wo, Re^Gvs, Re^Gvs, Re^Gvs, Wo, Gg, Gg, Rd, Gg, Rd, Gg, Gg, Hh, Hh, Gg, Gg, Gg, Mm, Hh, Hh, Gg^Vc, Gg, Gg, Hh, Hh, Mm^Xm, Mm^Xm, Mm, Re^Gvs, Re^Gvs, Gg, Gg, Hh^Fms, Gg, Gg, Gg, Gg, Hh^Fms, Hh, Gg, Gg, Gg, Gg, Gg, Gg, Gg, Gg, Gg, Gs^Fms, Rp, Gg, Gg, Gg, Hh, Hh, Gg, Re^Gvs, Gs^Fms, Re^Gvs, Gg, Gg, Gg, Rp, Gg, Gs^Fms, Gg, Gg, Ww, Ww, Gg, Re^Gvs, Re^Gvs, Hh, Gg, Hh^Fp, Gg, Gg, Rd, Gg, Wo, Wo, Wo, Wo, Wo
Gs^Fp, Gg, Gs^Fp, Rp, Rp, Hh, Hh, Mm, Mm, Mm^Xm, Mm, Hh, Hh, Rd, Rd, Mm^Xm, Gg, Wo, Mm^Xm, Wo, Wo, Wo, Re^Gvs, Wo, Wo, Gs^Fmf, Hh, Gg, Gg, Gg, Hh, Hh, Gg, Gg, Rr, Hh, Gg, Gg, Rr, Gg, Gg, Gg, Hh, Mm, Mm, Mm, Hh, Gg, Gg, Gs^Fms, Gs^Fms, Gg, Gg, Gg, Gs^Fds, Gg, Gg, Gg, Gg, Hh, Gg, Gg, Hh, Gg, Gg, Gs^Fds, Rp, Rp, Gg, Gs^Fds, Gs^Fds, Hh, Gg, Re^Gvs, Re^Gvs, Re^Gvs, Gg, Gg, Re^Gvs, Gg, Gg, Rp, Gg, Gg, Hh, Gg, Wo, Hh, Gg, Hh^Fmw, Mm, Mm, Hh, Gg, Hh^Fp, Re, Wo, Wo, Wo, Wo, Wo, Wo
Gg, Gg, Gg^Ve, Gs^Fp, Rp, Hh, Hh^Fp, Mm, Mm, Mm^Xm, Mm^Xm, Hh, Gg, Gg^Vh, Gg, Rd, Rd, Hh, Hh, Mm^Xm, Gs^Fms, Re^Gvs, Re^Gvs, Re^Gvs, Wo, Gs^Fmf, Mm^Xm, Gg, Gg, Gg, Gg^Vc, Gg, Gg, Rr, Gs^Fp, Rr, Rr, Rr, Hh, Gg, Gg, Gg, Gg, Hh, Hh, Hh, Gg, Hh^Fms, Gg, Gs^Fms, Hh, Gs^Fms, Gg, Gg, Gg, Gg, Gg, Gg, Gg, Gs^Fms, Gg, Gs^Fds, Hh^Fds, Gs^Fds, Hh, Gs^Fds, Rp, Gs^Fds, Gg, Gs^Fds, Gg, Gs^Fds, Hh, Gg, Rd, Re^Gvs, Gg, Gg, Hh, Re^Gvs, Gg, Rp, Rp, Gg, Gg, Gg, Gs^Fms, Wo, Gg, Hh^Fmw, Mm, Hh^Fmw, Hh, Gg, Gg, Re, Wo, Wo, Hh, Wo, Wo, Wo
Gs^Ft, Gs^Ft, Gs^Fp, Rp, Gg, Gg, Gg, Hh, Hh, Mm, Mm^Xm, Hh, Hh, Gg, Gg, Gg, Rd, Hh, Re^Gvs, Re^Gvs, Gg, Gg, Gg, Gg, Gg^Vh, Wo, Wo, Wo, Wo, Hh, Hh, Rr, Rr, Rr, Gg, Gg, Gg, Gg, Hh, Hh, Hh, Gg, Gg, Hh, Hh, Hh^Fds, Gg, Gg, Gg, Hh, Mm, Hh, Gs^Fms, Gg, Hh, Hh, Hh, Gg, Gg, Gg, Gs^Fds, Gg^Ve, Gs^Fms, Gg^Fet, Gg, Gs^Fds, Rp, Gg^Ve, Gs^Fms, Gg, Hh, Gg, Re, Gg, Rd, Gg^Vh, Gg, Hh, Re^Gvs, Gg, Gg, Gg, Gg^Vh, Gs^Fms, Gg, Gg, Gg, Wo, Re^Gvs, Gg, Gg, Gg, Gg^Vc, Gg, Re, Re, Wo, Wo, Hh^Fp, Wo, Wo, Wo
Ss, Gs^Ft, Gs, Rp, Rp, Gg, Ss, Hh^Fp, Hh, Mm, Mm, Mm, Hh, Gg, Re^Gvs, Gg, Gg^Vh, Rd, Rd, Gs^Fp, Gg, Gg, Rd, Gg, Rd, Gg, Hh, Gs^Fms, Gg, Ww, Gg, Gg, Gg, Rr, Rr, Gg, Gs^Fp, Gg, Gg, Mm, Gg^Vc, Gg, Hh^Fds, Hh, Mm^Xm, Mm^Xm, Mm, Gg, Hh, Mm, Mm, Mm, Mm, Gg, Mm, Mm, Mm, Gg, Gg, Gs^Fds, Hh, Gg, Hh, Gs^Fds, Rp, Rp, Gs^Fds, Gs^Fms, Gs^Fms, Re, Re, Re, Gg, Re, Re, Gg, Gg, Re^Gvs, Re^Gvs, Gg, Gs^Fms, Gg, Re, Gg, Gg, Gg, Wwf, Ww, Re^Gvs, Re^Gvs, Gg, Hh, Hh, Gg, Re, Gg, Gg, Wo, Wo, Hh^Fp, Wo, Wo
Gs^Ft, Ss, Gs^Fmw, Gs^Ft, Rp, Gs^Fmw, Rp, Gs^Fmw, Gs^Fp, Hh, Hh, Hh, Gg, Re^Gvs, Re^Gvs, Gg, Gg, Gg, Rd, Gg, Rd, Rd, Gg, Rd, Gg, Rd, Rd, Gg, Gg, Wwf, Ww, Gg, Hh, Gg^Vc, Hh, Rr, Rr, Rr, Hh, Gg, Gg, Gg, Hh, Hh, Mm^Xm, Mm, Mm, Mm^Vhh, Mm, Mm, Mm, Mm, Mm, Mm^Vhh, Gg, Mm, Gs^Fds, Gg, Gg, Gs^Fds, Gg, Gs^Fds, Gs^Fds, Gs^Fms, Rp, Gs^Fds, Gg^Fet, Hh, Gg, Gg, Gg, Gs^Fms, Gg, Hh, Re, Gg, Gg, Gg, Gg, Gg, Gg, Gg, Re, Hh, Hh, Ww, Gs^Fms, Gg, Hh, Gg, Re, Gg, Re, Gg, Re, Gg, Gg, Wo, Wo, Wo, Wo, Wo
Gs^Ft, Gs^Ft, Gg, Gg^Ve, Gs^Ft, Rp, Gs, Rp, Rp, Gs^Fp, Gs^Fp, Gs^Fp, Gg, Gg, Gg, Gg, Hh, Gg, Hh, Rd, Gg, Gg^Vh, Gg, Gg, Hh, Gg, Gs^Fp, Rd, Re, Gg, Gs^Fp, Wo, Re^Gvs, Hh, Hh, Gg, Gg, Hh, Hh, Gg, Gg, Gg, Hh, Mm^Xm, Mm, Mm, Mm, Mm, Mm, Mm, Mm^Xm, Hh, Hh, Hh, Hh, Hh^Fds, Gg, Hh, Gg, Gg, Gg, Gs^Fds, Rp, Gg^Ve, Hh, Gs^Fds, Gs^Fds, Gs^Fds, Gg, Gg, Hh, Gg, Gg, Gg, Rd, Re, Re, Re, Re, Gg, Re, Re, Gs^Fms, Gg, Wo, Wo, Re^Gvs, Hh, Gg^Vc, Re, Gg, Re, Hh, Re, Gg, Gg^Vc, Gg, Gg, Wo, Wo, Wo, Wo
Ss, Gs, Gs^Ft, Gg, Gs, Gs^Ft, Gs, Gs, Gs^Ft, Gg^Ve, Gg, Gg, Gg, Hh, Gs^Fp, Gg, Mm, Hh, Mm, Hh, Hh, Gg, Gg, Hh, Mm^Xm, Gg, Hh, Gs^Fp, Re, Gg, Gg, Wo, Wo, Re^Gvs, Re^Gvs, Gs^Fp, Gg^Vc, Hh, Gg, Gg, Gg, Hh^Fds, Mm, Mm^Xm, Mm, Mm, Mm, Mm, Mm^Xm, Mm, Hh^Fds, Mm^Xm, Mm, Mm, Mm, Mm, Mm^Vhh, Gg, Hh, Gg, Gg, Rp, Gs^Fms, Gg, Gs^Fds, Gg, Gg, Gg, Gg, Gg, Gs^Fms, Hh, Gg, Gg^Vh, Rd, Gg, Hh, Hh, Gg, Re, Gg, Gg, Gg, Gg, Wo, Re^Gvs, Re^Gvs, Gg, Gg, Hh, Hh, Gg, Gg, Re, Re, Hh, Hh, Gg, Wo, Wo, Wo, Wo
Ss, Ss, Ss, Gs, Gs, Ss, Ss, Gs^Ft, Gs, Gs^Ft, Gs, Gg, Gg, Gg, Gg, Gg, Mm, Mm^Xm, Mm, Mm, Hh, Gg, Hh, Mm^Xm, Hh, Gs^Fp, Gs^Fp, Gg^Ve, Gg, Re, Gs^Fms, Gg, Wo, Re^Gvs, Hh, Gg, Hh, Gg, Hh^Fms, Gg, Gg, Hh, Hh, Mm, Hh, Mm, Mm, Mm^Xm, Mm, Mm, Mm, Mm, Mm, Mm, Mm, Mm, Mm, Mm, Hh^Fms, Hh, Gg, Rp, Hh, Gs^Fds, Gs^Fds, Gg, Gg, Gg, Gg, Gg, Gg, Gg, Gg, Gg, Rd, Gg, Gg, Hh, Re^Gvs, Rd, Gg, Gs^Fms, Gg, Gg, Wwf, Re^Gvs, Gg, Gg, Gs^Fmw, Gg, Re^Gvs, Re^Gvs, Hh, Hh, Re, Hh, Gg^Vc, Wo, Wo, Wo, Wo, Wo
Ss, Ss, Gs^Ft, Ss, Ss, Ss, Ss, Ss, Ss, Gs, Ss, Gs, Gs, Gs, Gs, Gg, Gg, Mm, Hh, Hh, Re, Gg, Gg, Gg, Gs^Fp, Gg^Fet, Gs^Fp, Gs^Fp, Gs^Fp, Re, Re, Gg^Ve, Wo, Hh, Mm, Mm, Mm, Hh^Fms, Mm, Hh^Fms, Hh, Gg, Mm^Vhh, Mm, Mm, Hh^Fds, Hh, Mm, Hh, Mm, Mm, Mm, Mm^Xm, Mm^Xm, Mm, Mm, Mm, Mm, Mm^Xm, Hh, Hh, Rp, Rp, Gs^Fms, Gg, Gg, Hh, Gg, Mm, Hh, Gg, Gg, Gg, Rd, Hh, Gg, Re^Gvs, Re^Gvs, Re^Gvs, Gg^Vh, Gg, Gg, Hh, Gs^Fms, Wwr, Gg, Hh, Hh, Gg, Gg, Gg, Re^Gvs, Gg^Vc, Hh, Re, Gg, Gg, Wo, Wo, Wo, Wo, Wo
Ss, Ss, Gs^Ft, Ss, Ss, Ss, Gs, Ss, Ss, Ss, Ss, Ss, Ss, Gs, Gs, Gg, Gg, Gg, Re, Re, Hh, Re, Gs^Fp, Gs^Fp, Gs^Fp, Gs^Fp, Gs^Fp, Gs^Fp, Gs^Fp, Gs^Fp, Re, Gs^Fp, Wo, Hh^Fms, Mm, Mm, Mm^Xm, Hh, Mm^Xm, Mm^Xm, Mm^Xm, Hh, Hh, Mm, Mm, Mm, Mm, Hh, Gg, Mm^Vhh, Gg, Mm, Mm, Mm, Mm, Mm, Mm, Mm^Xm, Mm, Mm, Hh, Gg, Gg, Rp, Rp, Gg, Gg, Mm, Mm, Mm, Hh, Gg, Rd, Rd, Hh, Hh, Hh, Re^Gvs, Hh, Gg, Hh, Hh, Mm, Ww, Gg, Gg, Gg, Hh, Gs^Fmw, Hh, Gg, Gs^Fmw, Gg, Re, Gg, Gs^Fmw, Wo, Wo, Wo, Wo, Wo, Wo
Gs, Gs, Ss, Gs, Ss, Ss, Gs, Gs^Ft, Gs^Ft, Ss, Ss, Ss, Gs^Ft, Gs, Gs, Hh, Gg^Vh, Gg, Re, Hh, Hh, Re, Re, Gs^Fp, Hh, Hh, Gs^Fp, Gs^Fp, Hh, Gs^Fp, Re, Gs^Fp, Gs^Fms, Wo, Hh^Fds, Mm^Xm, Mm, Mm^Xm, Mm, Mm^Xm, Mm^Xm, Mm, Mm, Hh, Gg, Mm, Mm^Xm, Mm, Mm, Hh^Fds, Hh, Hh, Mm, Hh, Hh, Mm, Mm, Mm^Xm, Hh, Hh^Fds, Gg, Gg, Hh^Fms, Gs^Fds, Rp, Hh, Hh^Fms, Hh, Hh, Hh, Hh, Rd, Gg, Hh, Hh, Mm, Mm, Mm^Xm, Mm, Hh, Mm, Mm, Hh, Wwf, Gs^Fp, Gs^Fmw, Gg, Gg, Gg, Gg, Gs^Fmw, Gg, Gg, Re, Gg, Wo, Wo, Wo, Wo, Wo, Wo, Wo
