Hd, Hd, Dd, Dd, Dd, Dd, Dd, Hd, Dd, Dd, Dd, Dd, Dd, Hd, Dd, Dd, Dd, Hd, Dd, Dd, Dd, Hd, Dd, Dd, Dd, Dd, Dd, Dd, Dd, Dd, Dd, Dd, Dd, Dd, Dd, Dd, Dd, Dd, Dd, Dd, Rd, Dd, Dd, Dd, Dd, Dd, Dd, Ds, Ds, Ds, Ds, Ds
Dd, Dd, Hd, Dd, Hd, Dd, Dd, Dd, Dd, Dd, Dd, Dd, Dd, Dd, Dd, Dd, Dd, Dd, Hd, Dd, Dd, Dd, Hd, Dd, Dd, Dd, Dd, Dd, Dd^Dc, Dd, Md, Dd, Dd^Do, Dd, Hd, Dd, Dd^Vda, Dd, Hd, Dd, Rd, Dd, Hd, Dd, Dd^Dc, Dd, Dd, Ds, Ds, Ds, Ss, Ds
Hd, Hd, Dd, Dd, Hd, Dd, Hd, Dd, Hd, Rr^Vd, Dd, Dd, Hd, Dd, Hd, Md, Hd, Dd, Dd, Dd, Dd^Vdt, Dd, Dd, Dd, Dd, Hd, Dd, Dd, Dd, Hd, Dd, Md, Dd, Dd, Dd, Dd, Dd, Rd, Rd, Rd, Dd, Dd^Vda, Rd, Rd, Rd, Rd, Dd^Vda, Dd, Ds, Ds, Ds, Ss
Hd, Dd, Hd, Dd, Dd, Dd, Dd, Dd, Dd, Rd, Dd, Dd, Dd, Dd, Dd, Md, Md, Hd, Dd, Dd, Rd, Dd, Hd, Dd, Dd^Vdt, Dd, Dd, Dd, Dd, Dd, Dd, Dd, Gs, Gs, Gs, Gs, Hd, Dd, Rd, Dd, Dd, Dd, Dd^Do, Dd, Dd, Dd, Gs, Dd, Ds, Ss, Ss, Gs^Ft
Dd, Dd, Hd, Dd, Dd, Hd, Dd, Hd, Dd, Dd, Hd, Dd, Dd, Dd^Dc, Dd, Hd, Dd, Dd, Dd, Dd, Rd, Dd, Dd, Dd, Rd, Hd, Dd, Dd, Dd, Dd, Dd, Gs, Gg, Gs, Gg, Gs, Gg, Dd, Dd^Vda, Dd, Hd, Md, Dd, Hd, Dd, Dd, Dd, Gs, Gs, Ss, Ss, Ds
Hd, Hd, Dd, Dd, Dd, Rr^Vd, Rd, Dd, Hd, Dd, Dd, Dd, Dd, Hd, Dd, Dd, Dd, Hd, Dd, Dd, Dd, Rd, Dd, Hd, Dd, Rd, Rd, Dd, Gs, Gs, Gs, Gs, Mm, Gg, Gg, Gg, Gg, Rd, Hd, Dd, Dd, Dd, Gs, Dd, Dd^Vda, Gs, Gs, Gs, Gs, Gs, Gs, Ss
Hd, Hd, Dd, Dd^Dc, Dd, Dd, Dd, Dd, Dd, Dd, Dd, Dd, Dd, Dd, Dd, Hd, Dd, Dd, Dd^Do, Hd, Dd, Rd, Gg, Dd, Gg, Gg, Gg, Rd, Gg, Gg, Mm, Mm^Xm, Mm^Xm, Mm, Hh, Gg, Gg, Rd, Hd, Hd, Dd, Dd, Gs, Dd, Dd, Hd, Gg, Gg, Dd, Gs, Gs, Ds
Md, Hd, Hd, Dd, Dd^Do, Hd, Dd, Dd, Hd, Dd, Dd, Dd, Hd, Dd, Hd, Dd, Dd, Gs, Dd^Vda, Dd, Rd, Rd, Gg, Gg, Gg, Gg, Gg, Rd, Rd, Mm, Mm, Mm^Xm, Mm^Xm, Mm, Hh, Gg, Gg, Rd, Rd, Hd, Dd, Gs, Gs, Gs, Gs, Gs, Gg, Gg, Gg, Dd, Dd, Gs
Md, Md, Md, Hd, Dd, Dd, Hd, Dd, Dd, Dd, Dd, Md, Md^Xm, Md, Dd, Dd, Hd, Hd, Dd, Rd, Gg, Rd, Rd, Hh, Hh, Gg, Gg, Gg, Rd, Hh, Hh, Mm^Xm, Mm^Xm, Mm^Xm, Mm^Xm, Hh, Hh, Gg, Gg, Rd, Rd, Gs, Gg, Ww, Ww, Dd^Do, Dd, Gg, Gg^Vh, Dd, Gg, Gs
Md^Xm, Md^Xm, Md^Xm, Hd, Hd, Hd, Hd, Dd, Hd, Dd, Hd, Md, Md, Hd, Hd, Dd, Dd, Dd, Rd, Rd, Gg, Gg, Rd, Hh, Gg, Gg, Gg, Gg, Gg, Gg^Vc, Mm, Hh, Mm^Xm, Mm^Xm, Mm^Xm, Mm, Mm, Hh, Gg, Gg, Rd, Gg, Gg, Ww, Wo, Dd, Gg, Gg, Gg, Gg, Gg, Gg
Md, Md^Xm, Md, Md^Xm, Md^Xm, Md^Xm, Hd, Dd, Dd, Dd, Dd, Md, Dd, Dd, Dd, Dd, Hd, Dd, Gs, Rd, Gg, Gg, Re^Gvs, Rd, Rd, Gg, Gg, Hh, Mm, Mm, Mm^Xm, Hh, Mm^Xm, Mm^Xm, Mm^Xm, Mm^Xm, Mm^Xm, Mm, Hh, Gg^Vh, Rd, Gg, Gg, Gg, Gg, Ww, Wo, Gg, Gg, Gg, Gg, Gg
Hd, Md, Hd, Hd, Gs^Ft, Hd, Dd, Dd, Md, Hd, Dd, Hd, Dd, Md, Dd, Dd, Dd, Dd, Gs, Gg^Vh, Gg, Re^Gvs, Re^Gvs, Gg, Rd, Re^Gvs, Gg, Hh, Mm, Mm, Mm, Mm^Xm, Mm^Xm, 1 Mm, 8 Mm, 2 Mm, Mm^Xm, Mm, Mm, Hh, Rd, Gg, Gg, Hh, Gg, Gg, Gg, Wo, Gg, Gg, Gg^Vh, Gg
Dd, Hd, Dd, Dd, Gs^Ft, Dd^Do, Dd, Hd, Hd, Dd, Dd, Dd, Dd, Hd, Dd, Dd, Gs, Gs, Gs, Gg, Gg, Gg, Gg, Gg, Gg^Vh, Re^Gvs, Gg, Gg, Gg^Vc, Mm, Mm, Mm^Xm, 5 Mm, 6 Mm, 3 Mm, 9 Mm, Mm^Xm, Mm, Hh, Hh, Rd, Gg, Hh, Gg, Gg, Gs^Fp, Gg, Wo, Wo, Gg, Gg, Hh
Dd, Dd, Dd, Dd^Vda, Rd, Rd, Dd, Dd, Dd, Dd, Dd^Vda, Hd, Dd, Dd, Dd, Dd, Gs, Gs, Ww, Gs, Ww, Gs^Fmf, Gg, Gg, Gg, Gg, Hh, Gg, Hh, Mm, Mm^Xm, Mm^Xm, Mm^Xm, 4 Mm, Mm^Xm, Mm^Xm, Mm, Mm, Hh, Gg, Rd, Gg, Gg, Gg, Gs^Fp, Gg, Gs^Fmw, Gg, Ww, Gg, Gg, Hh^Fp
Dd, Hd, Dd, Dd, Dd, Dd, Dd, Hd, Dd, Rd, Dd, Rd, Dd, Dd, Gs, Gs, Gs, Ww, Ww, Ww, Ww, Gs^Fmf, Gg, Gg, Gg, Gg, Hh, Hh, Mm, Mm^Xm, Mm^Xm, Mm^Xm, Mm, Mm^Xm, Mm, Mm^Xm, Ww, Hh, Hh, Gg^Vh, Gg, Rd, Rd, Hh^Fp, Rd, Gg^Ve, Hh, Gg, Gg, Ww, Gg, Gg
Dd, Dd, Hd, Dd, Dd, Hd, Dd, Dd, Dd, Dd, Hd, Rd, Rd, Rd, Gs, Gs, Rd, Gs, Gg, Ww, Gg, Gg, Gg, Gg, Gg, Gg, Gs^Fmf, Hh, Mm, Mm, Mm, Mm, Mm, Mm, Mm^Xm, Ww, Ww, Hh, Gg, Gg, Gg, Gg, Rd, Rd, Gs^Fp, Gg, Gg^Fet, Gs^Fp, Gg, Ww, Ww, Wwf
Hd, Dd, Dd, Dd, Dd, Dd, Dd^Dc, Dd^Do, Hd, Dd, Dd, Dd, Gs, Rd, Rd, Rd, Gg^Vh, Gg, Re^Gvs, Ww, Gg^Vh, Gg, Gg, Gg, Gg, Gg, Gg, Hh, Hh, Mm, Hh, Hh, Mm, Ww, Mm^Xm, Mm, Mm, Ww, Ww, Gs^Fmw, Gs^Fmw, Gs^Fp, Gg^Ve, Gs^Fp, Gs^Fp, Gs^Fp, Gs^Fp, Gs^Fp, Hh, Ww, Hh, Gg
Dd, Dd, Dd, Hd, Dd, Dd, Dd, Dd, Dd, Dd, Dd, Gs, Gs, Gg, Gg, Gg, Gg, Gg, Re^Gvs, Ww, Ww, Gg, Gg, Gg, Gg, Gg, Gg, Gg, Gg, Hh, Gg, Mm, Mm^Xm, Mm^Xm, Mm^Xm, Mm, Hh, Hh, Ww, Ww, Gg, Gg, Wo, Wo, Ww, Gg, Hh, Hh, Ww, Ww, Hh, Gs^Fp
Dd, Hd, Dd, Dd, Dd^Vda, Dd, Dd, Hd, Dd, Dd, Dd, Gs, Hh, Hh, Gg, Gg, Dd, Gg, Re^Gvs, Re^Gvs, Wo, Gg, Gs^Fmf, Gg, Gs^Fmf, Gg, Gs^Fdf, Gg, Gg, Gg, Gg, Mm, Gs, Hh, Gs, Hh, Gg, Gg, Wo, Wo, Ss, Gg, Ww, Wo, Gg, Ww, Ww, Ww, Mm, Mm, Hh, Gs^Fp
Hd, Dd, Dd, Dd, Gs^Ft, Rd, Dd, Dd, Gs, Dd, Gs, Gs, Gg, Gg, Gg, Dd, Dd, Gg, Gg, Hh, Wo, Gs^Fdf, Gg, Gg, Gg, Hh, Hh, Gs^Fdf, Gs^Fmf, Gg, Gg, Gg, Gs, Gs, Gs, Gg, Gg, Gg, Wo, Ss, Ss, Ww, Wo, Ww, Gg, Ww, Ww, Hh, Hh, Hh, Gg, Gg
Dd, Dd, Ww, Ww, Gs^Ft, Rd, Rd, Rd, Rd, Gs, Gs, Gs, Gg, Gg, Gg, Dd, Gg, Dd, Gg, Gg, Ww, Gg, Gg^Ve, Gs^Fdf, Gs^Fmf, Gs^Fdf, Gs^Fmf, Gs^Fmf, Gs^Fdf, Gs, Gs, Gs, Ss, Dd, Dd, Ss, Ww, Ww, Ww, Ww, Ww, Wo, Wo, Ww, Wo, Wo, Ss, Gg, Gg, Gg, Gg, Rd
Dd, Dd, Ww, Dd^Do, Gs^Ft, Gs^Ft, Gg, Gg, Gg, Rd, Gg, Gg, Gg, Gg^Vh, Re^Gvs, Gg, Gg, Gg, Gg, Ww, Re, Gg, Gs^Fmf, Gs^Fdf, Gs^Fdf, Gs^Fmf, Gg, Gg^Ve, Gg, Gs, Dd, Ss, Ww, Ww, Ss, Ss, Ss, Wo, Wo, Wo, Wwr, Wo, Ww, Ww, Ww, Wo, Ww, Gg, Gg, Gg, Re, Re
Ww, Ww, Ww, Ww, Dd, Gs, Gg, Gg, Gg^Vh, Rd, Rd, Gg, Hh, Hh, Re^Gvs, Re^Gvs, Gg, Gg, Gg, Wo, Re, Gg, Gg, Gg, Gg, Gg, Gg, Gs^Fdf, Hh, Gs, Gs, Ss, Ss, Ww, Dd, Ss, Ss, Wo, Wo, Wo, Gs^Fdw, Ww, Wo, Ww^Vm, Ww, Ww, Gs^Fdw, Ww, Gg, Re, Gg, Gg
Ww, Ww, Gs, Dd, Gs, Gs, Gg, Gg, Gg, Gg, Rd, Gg, Gg, Gg, Gg, Re^Gvs, Gg, Gg, Wo, Wo, Gg, Re, Gg, Gg, Hh, Hh, Mm, Hh, Mm, Hh, Hh, Ww, Gs, Dd, Gg, Gg, Gg, Wo, Ss, Wo, Ww, Wo, Wo, Wwf, Wo, Gs^Fdw, Wo, Wo, Gg, Re, Gg, Gg
Ww, Ww, Gs^Fp, Gs, Gs, Hh, Hh, Hh, Gg, Gg, Rd, Gg, Dd, Dd, Gg, Gg, Gg, Wo, Gs, Gg, Gg, Re, Re, Gg, Hh, Mm, Mm^Xm, Mm, Mm^Xm, Mm, Mm, Gs, Gs, Gs, Hh, Gg, Ww, Ww, Ss, Ss, Wo, Ww, Wwf, Ww, Wo, Wo, Wo, Gg, Gg, Re, Re, Gg
Gs^Fp, Gs^Fp, Gs, Gs, Hh, Hh, Gs^Fp, Hh, Gg, Gg, Rd, Gg, Dd, Gg, Gs^Fp, Gs^Fp, Wo, Wo, Gs, Gs, Gs, Gg^Vh, Re, Hh, Mm, Mm, Mm, Mm^Xm, Mm^Xm, Mm^Xm, Mm, Hh^Fp, Mm, Mm, Mm, Hh, Ww, Wwf, Ww, Wo, Wo, Ww^Vm, Ww, Wo, Gg, Wo, Wo, Wo, Gs^Fp, Gs^Fp, Re, Gs^Fp
Gg^Fet, Gs^Fp, Gs, Gg, Gg, Hh, Gg, Gg, Rd, Rd, Gg, Gg, Gg, Gg, Mm, Gs^Fp, Wo, Gg^Vh, Gg, Gs, Gs, Gg, Gg, Re, Hh, Mm, Hh, Mm, Mm^Xm, Mm^Xm, Mm^Xm, Mm, Gg, Mm, Mm, Hh^Fms, Wwr, Ww, Gg, Wo, Ww, Ww, Ww, Wo, Gs^Fms, Gg, Gg, Gg^Vh, Gg, Gs^Fp, Re, Gg
Gs^Fp, Hh, Hh, Gg, Gg, Gg, Gg, Gg, Rd, Gg^Vh, Gg, Gg, Gg, Mm, Mm, Wo, Gg, Gg, Gg, Gs, Gs, Gs, Gg, Re, Gg, Hh, Gs^Fdf, Hh, Hh, Mm^Xm, Mm, Mm^Xm, Mm, Gg, Mm^Xm, Hh, Hh, Gg, Gg, Gg, Gg, Gg, Wwf, Gg, Gg, Gg, Gg, Gg, Hh, Gg, Gg, Re
Gs^Fp, Gs^Fp, Gs^Fp, Gg, Gs^Fp, Gg, Gg, Gg, Rd, Re^Gvs, Re^Gvs, Re^Gvs, Re^Gvs, Hh, Ww, Wo, Gs^Fmf, Gg, Re, Gg, Gs^Fdf, Gs, Re, Re, Gg^Vh, Gg, Ww, Gg, Mm, Mm, Mm^Xm, Mm^Xm, Mm^Xm, Mm, Mm, Mm, Mm, Hh^Fp, Gg, Gg, Gg, Gg, Gg, Wo, Wo, Gg, Gg, Gg, Rp, Gg, Rp, Rp
Gs^Fp, Gg^Fet, Hh, Gs^Fp, Gs^Fp, Gg, Gg, Gg, Gg, Rd, Re^Gvs, Re^Gvs, Gg, Gg, Wwf, Gs^Fmf, Gs^Fmf, Re, Gg^Vh, Re, Re, Re, Gs, Gs, Gg, Gg, Ww, Hh, Mm, Mm^Xm, Mm, Mm^Xm, Mm^Xm, Mm, Mm, Mm, Hh, Hh, Gg, Gg, Gg, Gg, Gg, Wo, Gg^Vh, Gg, Rp, Rp, Gg, Rp, Gs^Fms, Gg
Gs^Fp, Gs^Fp, Gs^Fp, Gg^Ve, Rp, Rp, Gg, Hh, Gg, Rd, Rd, Re^Gvs, Gg, Wo, Hh, Hh, Gg, Gg, Gg, Gs, Gs, Gs, Gs, Gs, Gs, Ww, Ww, Hh, Mm, Mm^Xm, Mm^Xm, Mm^Xm, Mm^Xm, Mm^Xm, Mm, Hh, Gg, Gg, Gs^Fp, Gs^Fp, Gg, Gg, Gg, Gg, Gg, Rp, Gs^Fms, Gg, Gg, Gg, Re^Gvs, Gg
Gs^Fp, Gs^Fp, Gg, Gg, Rp, Gg, Gg, Gg, Gg, Gs^Fp, Gs^Fp, Rd, Gg, Wo, Wo, Hh, Hh, Gg, Gg, Gg, Gs, Gs, Gs, Re^Gvs, Re^Gvs, Gg, Hh, Hh, Mm^Xm, Mm^Xm, Mm^Xm, Hh, Mm, Mm, Gg, Hh, Gg, Gs^Fp, Gs^Fp, Gs^Fp, Gs^Fp, Gg, Gg, Gg, Hh, Rp, Rp, Gg, Gg, Re^Gvs, Re^Gvs, Gg
Gs^Fp, Gs^Fp, Gs^Fp, Gg, Rp, Gs^Fp, Gs^Fp, Gs^Fp, Hh, Gg^Fet, Hh, Rd, Gg, Gg, Wo, Hh, Gg^Vh, Gg, Gg, Gg, Gg, Gs, Gg^Vh, Re^Gvs, Gg, Gg, Hh, Mm, Hh^Fms, Mm, Hh, Hh, Hh, Gg, Gg, Gg, Gg, Gg, Gg, Gs^Fp, Gg, Gg, Hh, Hh, Mm, Hh, Hh, Gg^Vh, Gg, Re^Gvs, Gg, Gg
Gs^Fp, Hh, Gg^Fet, Rp, Gg, Gg^Ve, Hh, Hh, Mm, Hh, Hh, Rd, Rd, Gg, Gg, Wo, Wo, Gg, Re^Gvs, Gs^Fp, Re^Gvs, Gg, Gg, Gg, Rd, Gg, Rd, Hh^Fms, Gg, Hh, Gg, Hh, Hh, Gg, Gg, Gg, Hh, Gg, Gg, Gg, Gg, Hh, Mm, Mm^Xm, Mm^Xm, Mm^Xm, Re^Gvs, Gg, Gg, Hh, Gg, Gg
Gs^Fp, Gs^Fp, Gs^Fp, Rp, Gg, Gs^Fp, Hh, Mm, Mm^Xm, Mm, Mm, Hh, Hh, Rd, Gg, Gs^Fp, Wo, Re^Gvs, Wo, Re^Gvs, Re^Gvs, Re^Gvs, Wo, Gg, Gg, Rd, Gg, Rd, Gg, Gg, Hh, Hh, Gg, Gg, Gg, Mm, Hh, Hh, Gg^Vc, Gg, Gg, Hh, Hh, Mm^Xm, Mm^Xm, Mm, Re^Gvs, Re^Gvs, Gg, Gg, Hh^Fms, Gg
Gs^Fp, Gg, Gs^Fp, Rp, Rp, Hh, Hh, Mm, Mm, Mm^Xm, Mm, Hh, Hh, Rd, Rd, Mm^Xm, Gg, Wo, Mm^Xm, Wo, Wo, Wo, Re^Gvs, Wo, Wo, Gs^Fmf, Hh, Gg, Gg, Gg, Hh, Hh, Gg, Gg, Rr, Hh, Gg, Gg, Rr, Gg, Gg, Gg, Hh, Mm, Mm, Mm, Hh, Gg, Gg, Gs^Fms, Gs^Fms, Gg
Gg, Gg, Gg^Ve, Gs^Fp, Rp, Hh, Hh^Fp, Mm, Mm, Mm^Xm, Mm^Xm, Hh, Gg, Gg^Vh, Gg, Rd, Rd, Hh, Hh, Mm^Xm, Gs^Fms, Re^Gvs, Re^Gvs, Re^Gvs, Wo, Gs^Fmf, Gg, Gg, Gg, Gg, Gg^Vc, Gg, Gg, Rr, Gs^Fp, Rr, Rr, Rr, Hh, Gg, Gg, Gg, Gg, Hh, Hh, Hh, Gg, Hh^Fms, Gg, Gs^Fms, Hh, Gs^Fms
Gs^Ft, Gs^Ft, Gs^Fp, Rp, Gg, Gg, Gg, Hh, Hh, Mm, Mm^Xm, Hh, Hh, Gg, Gg, Gg, Rd, Hh, Re^Gvs, Re^Gvs, Gg, Gg, Gg, Gg, Gg^Vh, Wo, Wo, Wo, Wo, Hh, Hh, Rr, Rr, Rr, Gg, Gg, Gg, Gg, Hh, Hh, Hh, Gg, Gg, Hh, Hh, Hh^Fds, Gg, Gg, Gg, Hh, Mm, Hh
Ss, Gs^Ft, Gs, Rp, Rp, Gg, Ss, Hh^Fp, Hh, Mm, Mm, Mm, Hh, Gg, Re^Gvs, Gg, Gg^Vh, Rd, Rd, Gs^Fp, Gg, Gg, Rd, Gg, Rd, Gg, Hh, Gs^Fms, Gg, Ww, Gg, Gg, Gg, Rr, Rr, Gg, Gs^Fp, Gg, Gg, Mm, Gg^Vc, Gg, Hh^Fds, Hh, Mm^Xm, Mm^Xm, Mm, Gg, Hh, Mm, Mm, Mm
Gs^Ft, Ss, Gs^Fmw, Gs^Ft, Rp, Gs^Fmw, Rp, Gs^Fmw, Gs^Fp, Hh, Hh, Hh, Gg, Re^Gvs, Re^Gvs, Gg, Gg, Gg, Rd, Gg, Rd, Rd, Gg, Rd, Gg, Rd, Rd, Gg, Gg, Wwf, Ww, Gg, Hh, Gg^Vc, Hh, Rr, Rr, Rr, Hh, Gg, Gg, Gg, Hh, Hh, Mm^Xm, Mm, Mm, Mm^Vhh, Mm, Mm, Mm, Mm
Gs^Ft, Gs^Ft, Gg, Gg^Ve, Gs^Ft, Rp, Gs, Rp, Rp, Gs^Fp, Gs^Fp, Gs^Fp, Gg, Gg, Gg, Gg, Hh, Gg, Hh, Rd, Gg, Gg^Vh, Gg, Gg, Gg, Gg, Gs^Fp, Rd, Re, Gg, Gs^Fp, Wo, Re^Gvs, Hh, Hh, Gg, Gg, Hh, Hh, Gg, Gg, Gg, Hh, Mm^Xm, Mm, Mm, Mm, Mm, Mm, Mm, Mm^Xm, Hh
Ss, Gs, Gs^Ft, Gg, Gs, Gs^Ft, Gs, Gs, Gs^Ft, Gg^Ve, Gg, Gg, Gg, Hh, Gs^Fp, Gg, Mm, Hh, Mm, Hh, Hh, Gg, Gg, Gg, Gg, Gs^Fp, Hh, Gs^Fp, Re, Gg, Gg, Wo, Wo, Re^Gvs, Re^Gvs, Gs^Fp, Gg^Vc, Hh, Gg, Gg, Gg, Hh^Fds, Mm, Mm^Xm, Mm, Mm, Mm, Mm, Mm^Xm, Mm, Hh^Fds, Mm^Xm
Ss, Ss, Ss, Gs, Gs, Ss, Ss, Gs^Ft, Gs, Gs^Ft, Gs, Gg, Gg, Gg, Gg, Gg, Mm, Mm^Xm, Mm, Mm, Hh, Gg, Hh, Gg, Gs^Fp, Gs^Fp, Gs^Fp, Gg^Ve, Gg, Re, Gs^Fms, Gg, Wo, Re^Gvs, Hh, Gg, Hh, Gg, Hh^Fms, Gg, Gg, Hh, Hh, Mm, Hh, Mm, Mm, Mm^Xm, Mm, Mm, Mm, Mm
Ss, Ss, Gs^Ft, Ss, Ss, Ss, Ss, Ss, Ss, Gs, Ss, Gs, Gs, Gs, Gs, Gg, Gg, Mm, Hh, Hh, Re, Gg, Gg, Gg, Gs^Fp, Gg^Fet, Gs^Fp, Gs^Fp, Gs^Fp, Re, Re, Gg^Ve, Wo, Hh, Mm, Mm, Mm, Hh^Fms, Mm, Hh^Fms, Hh, Gg, Mm^Vhh, Mm, Mm, Hh^Fds, Hh, Mm, Hh, Mm, Mm, Mm
Ss, Ss, Gs^Ft, Ss, Ss, Ss, Gs, Ss, Ss, Ss, Ss, Ss, Ss, Gs, Gs, Gg, Gg, Gg, Re, Re, Hh, Re, Gs^Fp, Gs^Fp, Gs^Fp, Gs^Fp, Gs^Fp, Gs^Fp, Gs^Fp, Gs^Fp, Re, Gs^Fp, Wo, Hh^Fms, Mm, Mm, Mm^Xm, Hh, Mm^Xm, Mm^Xm, Mm^Xm, Hh, Hh, Mm, Mm, Mm, Mm, Hh, Gg, Mm^Vhh, Gg, Mm
Gs, Gs, Ss, Gs, Ss, Ss, Gs, Gs^Ft, Gs^Ft, Ss, Ss, Ss, Gs^Ft, Gs, Gs, Hh, Gg, Gg, Re, Hh, Hh, Re, Re, Gs^Fp, Hh, Hh, Gs^Fp, Gs^Fp, Hh, Gs^Fp, Re, Gs^Fp, Gs^Fms, Wo, Hh, Mm^Xm, Mm, Mm^Xm, Mm, Mm^Xm, Mm^Xm, Mm, Mm, Hh, Gg, Mm, Mm^Xm, Mm, Mm, Hh^Fds, Hh, Hh
