Ss, Ss, Gs^Ft, Ss, Ss^_fme, Ss, Gs, Ss, Ss, Ss, Ss, Ss, Ss, Gs, Gs, Gg, Gg, Gg, Re, Re, Hh, Re, Gs^Fp, Gs^Fp, Gs^Fp, Gs^Fp, Gs^Fp, Gs^Fp, Gs^Fp, Gs^Fp, Re, Gs^Fp, Wo, Hh^Fms, Mm, Mm, Mm^Xm, Hh, Mm^Xm, Mm^Xm, Mm^Xm, Hh, Hh, Mm, Mm, Mm, Mm, Hh, Gg, Mm, Gg, Mm
Gs, 1 Gs, Ss, Gs^_fme, Ss^_fme, Ss, Gs, Gs^Ft, Gs^Ft, Ss, Ss, Ss, Gs^Ft, Gs, Gs, Hh, Gg^Vh, Gg, Re, Hh, Hh, Re, Re, Gs^Fp, Hh, Hh, Gs^Fp, Gs^Fp, Hh, Gs^Fp, Re, Gs^Fp, Gs^Fms, Wo, Hh, Mm^Xm, Mm, Mm^Xm, Mm, Mm^Xm, Mm^Xm, Mm, Mm, Hh, Gg, Mm, Mm^Xm, Mm, Mm, Hh^Fds, Hh, Hh
Ss, Gs, Gs^Ft, Ss^_fme, Gs^_fme, Gs^Ft, Gs^Ft, Ss, Gs^Ft, Ss, Ss, Gs, Ss, Ss, Gs, Gs, Gg, Re, Hh, Re^Gvs, Gs^Fp, Hh, Gg^Ve, Re, Re, Re, Re, Gg^Fet, Re, Re, Gs^Fp, Re, Gg^Fet, Wo, Hh, Hh, Mm, Mm, Mm, Mm, Mm^Xm, Mm, Mm, Mm, Mm^Vhh, Mm, Mm, Mm, Mm, Mm, Hh^Fds, Mm
Ss, 2 Gs, Ss, Ss^_fme, Ss^_fme, Ss, Gs, Ss, Gs, Ss, Ss, Ss, Ss, Ss, Gs, Gg, Re, Re, Gg, Re^Gvs, Re^Gvs, Gs^Fp, Gg, Gg^Fet, Gs^Fp, Gs^Fp, Gs^Fp, Re, Gs^Fp, Gs^Fp, Gs^Fp, Gg^Ve, Gg, Wo, Hh^Fms, Hh^Fms, Hh, Mm, Mm, Mm, Mm, Mm^Xm, Mm, Hh, Mm, Gg, Hh, Mm, Mm, Mm, Mm, Mm^Xm
Ss, Ss, Gs, Ss^_fme, Ss^_fme, Gs, Ss^Vhs, Ss, Ss, Gs^Ft, Gs, Gs, Ss, Ss, Ss, Re, Gg, Gg, Gg, Gg, Gg, Gg, Gs^Fp, Gs^Fp, Gs^Fp, Gs^Fms, Gg^Ve, Re, Gs^Fp, Gs^Fp, Wo, Gs^Fms, Wo, Wo, Wwr, Hh, Wo, Hh, Hh, Mm, Mm, Mm^Xm, Mm^Xm, Mm, Mm, Mm, Mm, Gg, Mm, Mm, Mm^Xm, Mm
Ss, 3 Ss, Ss, Gs^_fme, Ss^_fme, Gs^Ft, Ss, Gs, Gs^Ft, Ss, Ss^Vhs, Ss, Ss, Ss, Ss, Re, Gg, Gg, Re^Gvs, Gs^Fp, Gg, Gg, Gg, Gg, Gg, Gg, Re, Gs^Fp, Wo, Wo, Re^Gvs, Wo, Gg^Vh, Hh, Hh, Ww, Hh, Wo, Hh^Fds, Hh, Hh, Mm, Mm^Xm, Mm, Mm, Mm, Mm, Mm^Vhh, Hh^Fds, Mm, Mm, Mm
Gg, Ss, Ss, Ss^_fme, Ss^_fme, Ss, Ss, Ss, Ss, Gs, Ss, Gs, Ss, Ss, Gs, Gg^Vh, Gg, Gg, Re^Gvs, Re^Gvs, Gg, Gg, Gg, Gg, Gg, Re, Gs^Fp, Rd, Wo, Re^Gvs, Re^Gvs, Gg, Gg, Gg, Hh, Hh, Hh, Wo, Ww, Hh, Hh, Mm, Mm, Mm^Xm, Mm^Xm, Mm, Hh^Fds, Gg, Mm, Hh, Mm^Xm, Hh
Gg, 4 Ss, Ss, Ss^_fme, Gs^_fme, Ss, Gs, Ss, Gs, Gs, Ss, Ss, Ss, Ss, Gs, Gs, Hh, Gg, Gg, Hh, Gs^Fp, Gs^Fp, Gg, Gg, Rd, Re, Gs^Fp, Wo, Re^Gvs, Re^Gvs, Gg, Gg, Re^Gvs, Re^Gvs, Re^Gvs, Hh, Rp, Gg^Vh, Gg, Ww, Hh^Fms, Hh, Mm, Mm, Mm^Xm, Hh^Fds, Hh^Fds, Gg, Hh, Mm, Mm, Hh^Fds
Ss, Ss, Gs^Ft, Gs^_fme, Gs^_fme, Gs^Ft, Gs, Gs, Gg, Gs, Gs, Gs, Gs, Gs, Gs, Hh, Gg, Gg, Hh, Hh, Hh, Gs^Fp, Gg, Gg, Rd, Gg, Wo, Wo, Gg, Gg^Vh, Rp, Rp, Rp, Rp, Rp, Rp, Gg, Rp, Gg, Ww, Ww, Hh, Mm, Mm, Mm, Mm^Xm, Gg, Gg, Gg, Hh, Hh, Hh
Gs^Ft, 5 Ss, Gs^Ft, Ss^_fme, Gs^_fme, Gs, Gs, Gg, Gg, Hh, Hh, Gs, Gs, Gs, Gs, Gg, Gg, Gg, Hh, Hh, Mm, Hh, Gg, Rd, Re^Gvs, Gg^Vh, Wo, Gg, Gg, Gg, Rp, Gs, Gs, Gg^Vh, Gg, Gg, Gg, Rp, Gg, Gg, Wo, Hh, Hh, Mm, Hh, Mm^Xm, Hh, Gg, Gg, Gg, Hh, Gg
Gs, Gs, Gs, Gs^_fme, Gs^_fme, Gs, Gs, Gs, Gs, Gg, Gg, Gs, Ss, Ss, Gs, Gs, Gg^Vh, Gg, Hh, Mm, Mm, Mm, Hh, Rd, Re^Gvs, Re^Gvs, Wo, Gg, Gg, Rp, Gs, Gs, Re^Gvs, Gg, Gg, Gg, Gs, Rp, Rp, Gg^Vh, Wo, Hh^Fms, Hh, Hh, Gg, Gg, Gg, Gg, Gs^Fds, Gs^Fds, Gs^Fds, Gg
Ss, 6 Gs, Gs, Gs^_fme, Hh^_fme, Gs, Gs, Gs^Vht, Rd, Gg, Gs, Gs, Gs^Ft, Ss, Ww, Gs, Rd, Hh, Mm, Mm, Mm, Mm, Hh, Rd, Rd, Wo, Gg, Gg, Rp, Rp, Gs, Gs, Re^Gvs, Re^Gvs, Gg, Gs, Gs, Gs, Rp, Gg, Gg, Wo, Wo, Ww, Ww, Ww, Wo^Bw/, Gg, Gg, Gg, Gg, Gg
Ss, Ss, Hh, Hh^_fme, Hh^_fme, Gg, Gs, Hh, Rd, Gs, Ss, Gs, Gs^Ft, Gs^Ft, Ww, Ss, Rd, Hh, Hh, Mm, Mm, Mm, Mm, Hh, Rd, Wo, Gg, Gg^Vh, Rp, Gs, Gs, Gs, Gg, Gg, Gs, Gs, Rp, Rp, Gs^Fp, Rp, Rp, Gg, Gg, Gg, Gg^Vh, Gg, Re^Gvs, Ww, Gg, Gs^Fds, Gg, Gs^Fds
Ss^_fme, Ss^_fme, Hh^_fme, Gs^_fme, Hh^_fme, Gg, Gs, Gs, Rd, Ss, Ss, Gs, Gs, Gs^Ft, Gg, Ww, Ww, Rd, Rd, Mm, Mm, Mm, Rd, Rd, Wo, Wo, Wo, Gg, Rp, Hh, Mm, Hh, Gg^Vh, Re^Gvs, Re^Gvs, Gs, Rp, Gs^Fp, Gg, Gg, Gg, Rd, Rd, Gg, Rd, Gg, Re^Gvs, Wwf, Ww, Gg, Gs^Fds, Hh^Fms
Gs^_fme, Gs^_fme, Gs^_fme, Gg^_fme, Gg^_fme, Gg, Gs^Ft, Gs^Ft, Rd, Ss, Gs^Vht, Gs, Gs, Gs, Gg, Gg, Gg, Wo, Gg^Vh, Rd, Rd, Mm, Gg^Vh, Rd, Wo, Gg, Wo, Gg, Hh, Rp, Rp, Rp, Rp, Re^Gvs, Re^Gvs, Rp, Gg, Gg, Gg, Gg, Gs^Fp, Gg, Gg, Rd, Gs, Gs, Re^Gvs, Re^Gvs, Gg, Ww, Ds, Gs^Fds
Wo, Gs, Gs^Vht, Gg, Gg, Gs, Gs, Ss, Gs, Rd, Rd, Gs, Gs, Gs^Ft, Ss, Gg, Wo, Wo, Hh, Gg, Hh, Rd, Gg, Gg, Re^Gvs, Wo, Gs^Fms, Wo, Wo, Hh, Mm, Hh, Hh, Rp, Rp, Rp, Hh, Gg, Gg, Gs^Fp, Gs^Fp, Gg, Gg, Rd, Rd, Rd, Rd, Rd, Rd, Ww, Wo, Ds
Wo, Gs, Wwf, Ww, Ww, Ww^Bw|, Wo, Ss, Ss, Gs, Gs, Rd, Rd, Ss, Gs, Gg, Wo, Hh, Hh, Hh, Mm, Hh, Hh, Re^Gvs, Wo, Wo, Gg, Gs^Fms, Wo, Mm, Mm^Xm, Mm, Mm, Hh, Mm^Xm, Hh, Mm, Hh, Hh, Gg, Gg, Gg, Gg, Gg^Vh, Hh, Hh, Hh, Hh, Hh, Rd, Rd, Wo
Wo, Wo, Gs, Ww, Ww, Gs, Gs^Vht, Wo, Ds, Gs, Gs, Gs, Rd, Gs^Vht, Ds, Ds, Wo, Hh, Hh, Mm, Mm, Mm, Hh, Wo, Gs^Fms, Gs^Fp, Gg^Ve, Hh, Gs^Fms, Wo, Mm^Xm, Mm^Xm, Mm^Xm, Mm^Xm, Mm^Xm, Mm^Xm, Mm^Xm, Mm^Xm, Hh, Gg, Gg, Gg, Gg, Hh, Mm, Mm, Mm, Mm, Hh, Rd, Rd, Wo
Wo, Wo, Wo, Gs, Wwf, Gs, Wo, Wo, Ds, Ds, Ds, Ds, Wo, Gs, Wo, Wo, Wo, Wo, Wo, Wo, Wo, Wo, Wo, Wo, Gs^Fp, Gg, Re, Gs^Fms, Gs^Fms, Mm, Mm, Mm^Xm, Mm, Mm, Mm, Mm, Hh, Hh, Rr, Gg, Gg, Gg, Hh, Hh, Mm^Xm, Mm, Mm^Xm, Mm, Hh, Hh, Hh, Rd
Wo, Wo, Wo, Wo, Wo, Ww, Ww, Wwr, Wo, Wo, Wo, Wo, Mm, Wo, Gg, Wo, Wo, Wo, Wo, Wo, Gg^Ve, Gs^Fms, Gs^Fp, Gs^Fp, Gg^Fet, Gg, Gs^Fds, Re, Hh, Hh, Hh, Mm, Mm, Mm, Hh, Hh, Rr, Rr, Hh, Rr, Rr, Rr, Mm, Mm^Xm, Mm^Xm, Mm^Xm, Mm^Xm, Mm, Hh, Mm, Mm^Xm, Rd
Wo, Ds, Wo, Wo, Wwf, Ww^Vm, Wo, Ww, Ww, Wo, Wo, Hh, Wo, Gg^Vh, Gg, Wo, Wo, Wo, Wo, Gs^Fp, Re, Gs^Fms, Gs^Fp, Gs^Fp, Gs^Fms, Gs^Fms, Gs^Fds, Re, Gg, Hh, Gg, Hh, Hh, Hh, Gg^Vc, Rr, Gg, Gs^Fp, Hh, Hh, Gg, Gg^Vc, Mm, Mm, Mm, Mm, Mm, Gg, Gg, Mm, Hh, Rd
Wo, Wo, Wo, Wo, Ww, Ww, Wo, Ww, Wo, Ww, Ds, Wo, Wo, Wo, Wo, Wo, Wo, Wo, Gg, Gs^Fp, Re, Re, Re, Re, Re, Gs^Fms, Re, Re, Gg, Gg, Hh, Gg, Gg, Gg, Gg, Hh, Hh, Gg, Re^Gvs, Gg, Gg, Hh, Mm, Mm, Ww, Mm, Hh, Gg^Vh, Re^Gvs, Re^Gvs, Hh, Rd
Wo, Wo, Ww, Wwf, Wo, Wwf, Ww^Vm, Wo, Wo, Wwr, Ds, Ds, Wo, Wo, Wo, Wo, Gs^Fms, Wo, Gg, Re, Gs^Fms, Gs^Fms, Gs^Fp, Gs^Fp, Gs^Fp, Re, Gg, Re, Gg, Hh, Hh, Gg, Gg, Gg, Gg, Hh, Gg, Gg, Hh, Re^Gvs, Re^Gvs, Hh, Wo, Wo, Ww, Ww, Gs^Fp, Hh, Mm, Re^Gvs, Hh, Hh
Wo, Wo, Wwr, Ww^Vm, Wo, Ww, Ww, Wo, Ww, Ds, Ds, Ww, Wo, Gs^Fms, Gs^Fp, Gg^Fet, Gs^Fp, Hh, Gs^Fp, Re, Gg, Gg^Fet, Gs^Fms, Gs^Fp, Gs^Fms, Gg^Ve, Gg, Re, Re, Gg, Gs^Fp, Gg, Gg, Gs^Fp, Gs^Fp, Gg, Rr, Gg^Vc, Hh, Re^Gvs, Re^Gvs, Wo, Mm, Mm, Mm, Hh, Re, Hh^Fp, Mm, Mm, Re^Gvs, Gg
Wo, Wo, Wo, Wo, Wo, Ww, Wo, Wwr, Wo, Ds, Ds, Wo, Wo, Wo, Gs^Fp, Gs^Fms, Re, Gs^Fp, Re, Gg^Ve, Gs^Fms, Hh^Fms, Hh^Fds, Gs^Fms, Gs^Fms, Gs^Fp, Gg, Gg, Re, Gg, Gg, Gg, Hh, Gg, Gg, Gg, Rr, Rr, Wo, Wo, Wo, Wo, Mm, Mm, Hh^Fms, Hh^Fms, Re, Mm, Hh, Hh, Re^Gvs, Re^Gvs
Ww, Wo, Wo, Wo, Wo, Wo, Wo, Wo, Wo, Wo, Wo, Gs, Gg, Gg^Ve, Gs^Fms, Hh, Gg, Re, Gg, Gs^Fms, Gg, Hh, Gs^Fms, Gg^Fet, Gg, Gs^Fp, Gg, Gs^Fp, Re, Gg, Gg, Gg, Gs^Fms, Gg, Gg, Gg, Rr, Gg, Gg, Gg, Gg, Gg^Vh, Rr, Rr, Rr, Gg^Vh, Re^Gvs, Re, Re, Re^Gvs, Re^Gvs, Re^Gvs
Ww, Ww, Wo, Wo, Ww, Wo, Wo, Wo, Wo, Wo, Wo, Gs^Fms, Gg, Gs^Fp, Gg, Gs^Fp, Gs^Fp, Gs^Fms, Gs^Fds, Gg, Gg, Gg, Gg, Gg, Gs^Fms, Gg, Gg, Hh, Re, Gg, Hh, Gg, Gs^Fms, Gs^Fms, Gg, Gg, Gg, Rr, Rr, Gg, Rr, Rr, Hh, Hh, Re^Gvs, Re^Gvs, Ww, Re^Gvs, Wo, Gg^Vh, Wo, Wo
Wwr, Ww, Wo, Wwr, Ww, Wo, Re^Gvs, Wo, Re^Gvs, Wo, Gg, Wo, Gg, Gg, Hh, Gs^Fp, Hh, Hh, Hh, Hh, Hh, Gg, Gg, Hh, Gg, Gs^Fms, Gg^Ve, Re, Gg, Hh, Hh, Gg, Gg, Gg, Gg, Gg, Hh, Gg, Gg, Rr, Gg, Hh, Mm, Hh, Re^Gvs, Wwf, Gg, Ww, Gg, Wo, Ds, Ds
Wo, Wo, Wo, Ww, Wo, Wo, Rp, Re^Gvs, Gg, Gg, Gg, Gg, Re^Gvs, Gs^Fms, Hh^Fp, Hh, Mm, Mm, Mm, Mm, Mm, Hh^Fms, Hh^Fms, Gg, Gs^Fp, Gs^Fp, Gs^Fms, Gg, Hh, Hh, Gs^Fms, Hh, Gg, Gg, Gg, Re^Gvs, Re^Gvs, Gg, Gg, Gg^Vh, Wo, Ww, Ww, Wwf, Ww, Wwf, Gg, Gg, Hh, Gs, Gs, Gs
Wo, Wo, Wo, Wo, Gg, Gg^Vh, Ww, Rp, Rp, Gg^Vh, Gs, Re^Gvs, Re^Gvs, Hh^Fp, Mm, Mm, Mm, Mm^Xm, Mm^Xm, Mm, Mm, Mm, Hh, Gg, Hh, Gs^Fp, Hh, Hh, Hh, Gs^Fms, Mm, Hh, Gg, Gg, Gg, Re^Gvs, Gg, Gg, Gg, Wo, Gs^Fmw, Hh, Hh, Re^Gvs, Re^Gvs, Gg, Hh, Hh, Mm, Hh, Hh, Gg
Wo, Wo, Wo, Wo, Wwr, Gg, Ww, Re^Gvs, Rp, Gs, Rp, Re^Gvs, Re^Gvs, Hh, Mm, Mm, Mm, Mm^Xm, Mm^Xm, Mm^Xm, Mm^Xm, Mm, Mm^Xm, Mm, Mm^Xm, Mm, Mm, Mm, Mm, Hh, Hh, Hh, Hh, Gg^Vh, Rd, Gg, Re^Gvs, Hh, Wo, Wo, Gs^Fmw, Hh, Gg, Re^Gvs, Re^Gvs, Gs, Hh, Mm, Mm, Mm, Hh, Hh
Ds, Wo, Wo, Wo, Gg, Ww, Gg, Wo^Bw/, Re^Gvs, Rp, Gs^Fp, Rp, Re^Gvs, Hh, Hh, Mm, Mm, Mm, Mm^Xm, Mm^Xm, Mm^Xm, Mm^Xm, Mm^Xm, Mm^Xm, Mm^Xm, Mm^Xm, Mm^Xm, Mm, Mm^Xm, Mm, Mm, Hh, Hh, Rd, Re^Gvs, Re^Gvs, Wo, Wo, Ss, Ss, Gs, Hh, Gg^Vh, Gg, Gs^Fp, Gs, Hh, Mm, Mm, Mm, Hh, Gg
Ds, Ds, Wo, Wo, Wo, Wwf, Gg^Vh, Ww, Ww, Re^Gvs, Re^Gvs, Rp, Rp, Re^Gvs, Hh, Hh, Mm, Mm, Mm, Mm^Xm, Mm, Mm, Wo, Mm, Wo, Mm^Xm, Mm^Xm, Mm^Xm, Mm, Mm, Mm, Gg, Rd, Rd, Re^Gvs, Re^Gvs, Wo, Ss, Gg, Ss, Gs, Gs, Gg, Gs^Fp, Gs^Fp, Gs, Hh, Hh, Hh, Hh, Re^Gvs, Hh
Ds, Ds, Ds, Wo, Wo, Wo, Wo, Ww, Re^Gvs, Re^Gvs, Mm^Xm, Hh^Fp, Hh, Rp, Hh, Hh, Mm, Mm, Mm^Xm, Mm^Xm, Mm^Xm, Wo, Wo, Wo, Wo, Mm^Xm, Mm^Xm, Mm^Xm, Mm, Mm, Hh, Gg^Vh, Gg, Gg, Wo, Wo, Re, Gg^Vh, Gg, Gs^Fdw, Ds, Ds, Ds, Gs^Fmw, Gs, Gs^Fp, Gg, Hh, Gs^Fms, Re^Gvs, Re^Gvs, Hh
Wwr, Ww, Ww, Wo, Wo, Wo, Hh, Re^Gvs, Mm^Xm, Mm^Xm, Mm, Mm, Hh, Rp, Mm, Hh, Hh, Mm, Mm^Xm, Ww, Wo, Wo, Wo, Wo, Wo, Wo, Mm^Xm, Mm^Xm, Mm, Mm, Wo, Gg, Gg, Wo, Wo, Re^Gvs, Re, Gs^Fdw, Gg, Ss, Ss, Ds, Ss, Gs^Fmw, Gs, Ds, Gg, Hh, Hh, Gg, Rd, Rd
Wwr, Ww, Wo, Wo, Re^Gvs, Wo, Hh, Mm, Mm^Xm, Mm, Mm, Mm, Hh, Rp, Rp, Hh, Mm, Mm, Mm^Xm, Mm, Hh, Hh, Re^Gvs, Re^Gvs, Wo, Wo, Wo, Wo, Wo, Wo, Wo, Wo, Wo, Wo, Gg^Vh, Re, Ss, Ds, Gs, Ss, Ds, Gs^Fmw, Ss, Ss, Rd, Gs, Gg, Re^Gvs, Re^Gvs, Gg^Vc, Gg, Hh
Ww, Ww, Gg^Ve, Re, Re, Wo, Hh, Mm, Mm, Mm^Xm, Mm, Hh^Fp, Hh^Fp, Hh, Gg^Vc, Hh, Mm, Mm^Xm, Mm, Hh, Hh, Re^Gvs, Re^Gvs, Gs, Rr, Wo, Wo, Wo, Wo, Wo, Re^Gvs, Wo, Wo, Wo, Gg, Re, Ss, Gs^Fdw, Gs, Gs^Fdw, Ss, Ss, Ss, Ss, Rd, Rd, Gg, Re^Gvs, Hh, Gs, Hh, Hh
Wo, Wwr, Wo, Gg^Fet, Re, Wo, Wo, Hh, Hh, Mm, Hh, Hh^Fp, Re^Gvs, Gg, Rd, Mm, Mm, Mm^Xm, Mm, Hh, Rp^Vhc, Re^Gvs, Rp, Rp, Rr, Rp^Vhc, Rr, Gg, Gg, Re^Gvs, Re^Gvs, Re^Gvs, Re^Gvs, Wo, Gg, Re, Re, Ss, Gs, Gs, Hh, Hh^Fms, Hh^Fmw, Dd^Dr, Gs^Fmw, Gg, Gg^Vc, Hh, Hh, Gs, Re^Gvs, Ss
Gs^Fp, Gs^Fp, Gs^Fms, Hh, Gs^Fms, Re, Wo, Gs^Fp, Gs^Fp, Hh, Hh, Re^Gvs, Gg, Rd, Hh, Hh^Fds, Mm, Mm^Xm, Mm, Hh, Rr, Rr, Gg, Hh, Hh, Rr, Hh, Rr, Rr, Gg, Rp^Vhc, Gs, Hh, Wo, Gs^Fmw, Gs^Fdw, Gg^Vh, Re, Gs, Gs, Gs, Hh, Ww, Gs^Fdw, Ss, Hh, Hh^Fmf, Re^Gvs, Mm, Hh, Gs^Fp, Re^Gvs
Gs^Fp, Gs^Fms, Gs^Fp, Gs^Fms, Gs^Fds, Re, Re, Ww, Gs^Fms, Hh^Fms, Hh, Gg, Gg^Vc, Rd, Hh^Fds, Hh^Fds, Mm^Xm, Mm^Xm, Mm, Hh, Rr, Gg, Gg, Hh, Gg, Rr, Gs, Gs, Gs, Rr, Rr, Hh, Mm, Wo, Wo, Gg, Re^Gvs, Re, Ss, Ss, Ss, Ds, Ww, Ww, Gs^Fmw, Ss, Hh^Fmf, Hh^Fmf, Hh, Hh, Hh, Gs^Fp
Gs^Fp, Gg, Gg, Gs^Fms, Gg^Fet, Gs^Fds, Re, Ww, Ww, Hh, Hh, Hh, Mm, Hh, Mm^Xm, Mm^Xm, Mm^Xm, Mm, Mm, Hh, Rr, Gg, Gg, Gg, Gg, Rr, Gs, Gs, Gs, Gs, Rr, Mm, Mm, Mm, Wo, Re^Gvs, Gs^Fp, Re, Gs^Fdw, Ds, Gs^Fdw, Ss, Hh^Fmw, Gs^Fms, Gs^Fdw, Ss, Re^Gvs, Re^Gvs, Gg^Vc, Hh^Fmf, Hh, Rd
Gs^Fp, Gg, Gs^Fms, Gg^Ve, Re, Re, Gs^Fds, Hh, Hh, Ww, Hh^Fds, Mm, Mm, Mm, Mm, Mm, Mm, Mm^Xm, Mm, Hh, Hh, Rr, Gg, Gg, Rr, Rp^Vhc, Re^Gvs, Re^Gvs, Gs, Gs, Rr, Hh, Hh, Hh, Hh, Wo, Wo, Re, Re, Ss, Gs^Fmw, Ss, Hh, Hh, Mm, Gs^Fmw, Gs^Fdf, Re^Gvs, Rd, Hh, Rd, Rd
Gs^Fp, Gs^Fp, Hh^Fp, Gs^Fp, Re, Gs^Fms, Gs^Fds, Gs^Fms, Mm, Ww, Wo, Hh, Wo, Wo, Wo, Wo, Wo, Mm^Xm, Mm^Xm, Mm, Hh, Rr, Rr, Rr, Gg, Re^Gvs, Re^Gvs, Re^Gvs, Re^Gvs, Gs, Gg, Rr, Gg, Gs^Fp, Gs^Fms, Gs^Fms, Ww, Gg, Gg^Ve, Gs^Fdw, Hh, Hh^Fmw, Mm, Mm, Mm, Mm, Hh^Fmf, Rd, Hh, Rd, Hh^Fmf, Gs^Fdf
Gs^Fp, Gs^Fp, Gs^Fms, Gs^Fp, Re, Gs^Fms, Gg^Fet, Hh, Gg, Hh^Fp, Hh^Fp, Wo, Hh^Fds, Gs^Fms, Gg, Ww, Ww, Hh, Mm, Hh, Re^Gvs, Rp^Vhc, Gg, Gg, Wo, Gg, Gg, Gg, Gg, Gg, Gg, Rp^Vhc, Re^Gvs, Re^Gvs, Gs^Fp, Gs^Fms, Gg, Ww, Gs^Fmw, Hh^Fmw, Hh, Mm, Mm, Mm^Xm, Mm^Xm, Hh, Rd, Rd, Mm, Mm, Mm, Hh^Fmf
Gg, Gs^Fms, Gg^Fet, Gs^Fms, Re, Gs^Fms, Gs^Fms, Gg, Gg, Gg, Gg, Gg, Gg, Rd, Gg^Vh, Gg, Wo, Hh, Hh, Hh, Re^Gvs, Re^Gvs, Re^Gvs, Wo, Wo, Wo, Wo, Wo, Wo, Gg, Gg, Rd, Rd, Re^Gvs, Gg, Gg^Ve, Gg, Ww, Ww, Ww, Ww, Hh, Mm^Xm, Mm^Xm, Mm^Xm, Mm, Rd, Mm^Xm, Mm^Xm, Mm, Re^Gvs, Hh
Gg, Gg, Gg, Re, Hh, Gg^Ve, Gg, Gs^Fds, Hh, Hh, Gs, Gg, Gg, Rd, Rd, Gg, Gg, Wo, Wwr, Ww, Wo, Wo, Wo, Wo, Wo, Wo, Wo, Wo, Ds, Wwr, Hh, Gg, Rd, Gs^Fp, Gs^Fp, Gs^Fp, Gs^Fms, Gg, Gg, Gg, Gg, Hh, Mm, Mm, Mm^Xm, Mm, Rd, Hh, Hh, Re^Gvs, Gs^Fdf, Hh^Fmf
Re, Re, Re, Re, Hh, Hh^Fp, Gg, Gs^Fds, Hh, Hh, Gs, Hh^Fp, Gg, Gg, Gg, Rd, Rd, Gg, Gg, Gg, Gg, Ds, Ds, Wo, Wo, Wo, Ds, Ds, Gg, Gg, Hh, Hh, Hh, Rd, Gs^Fms, Gs^Fp, Hh, Gg, Gg, Gg, Gg, Hh, Hh, Mm, Mm, Mm, Rd, Gs, Gs, Gg^Vh, Gg, Ss
Gs^Fp, Gs^Fp, Gg^Ve, Gg^Fet, Gs^Fms, Gs^Fms, Ur^Ii, Gs, Gs, Gs, Gs, Gs, Gg^Vh, Gg, Gg, Gg, Rd, Gs^Fms, Hh, Hh, Gg, Gg, Gg, Ds, Ds, Wo, Ds, Ds, Gg, Hh, Mm, Mm, Hh, Rd, Rd, Hh, Rd, Rd, Rd, Rd, Rd, Gg^Vh, Rd, Hh, Rd, Gg^Vh, Rd, Rd, Rd, Rd, Rd, Gs
Xu, Xu, Xu, Gs^Fms, Xu, Xu, Uh, Ur^Ii, Ur^Ii, Gs, Gg, Gg, Dd, Gg, Dd, Dd, Dd, Rd, Rd, Rd, Rd, Gg^Vh, Re^Gvs, Gg, Gg, Ds, Rd, Gg^Vh, Gg, Hh, Hh, Hh, Hh, Hh, Hh, Rd, Re^Gvs, Re^Gvs, Re^Gvs, Gs^Fms, Gs^Fms, Rd, Rd, Rd, Rd, Rd, Dd, Dd, Dd, Rd, Dd, Rd
Uu, Uh, Uu, Xu, Ql, Ql, Uu, Ur, Ur^Ii, Gs, Hd, Dd, Hd, Dd, Md^Xm, Md, Md, Dd, Dd, Dd, Rd, Re^Gvs, Gs, Gs, Rd, Rd, Dd, Rd, Rd, Gg, Rd, Rd, Rd, Hh, Hh, Rd, Re^Gvs, Re^Gvs, Gg, Gs^Fp, Gg, Gg, Hd, Dd, Hd, Dd, Rd, Hd, Dd, Dd, Md, Dd
Ql, Ql, Uu, Uh, Ur, Uu^Vu, Ur, Uh, Tb^Tf, Xu, Hd, Md, Md, Md^Xm, Md^Xm, Md^Xm, Md^Xm, Md^Xm, Dd, Dd, Rd, Rd, Gs, Rd, Dd, Dd, Md^Xm, Dd, Dd, Rd, Gg^Vh, Gs^Fp, Rd, Hh, Rd, Rd, Gg, Re^Gvs, Gg, Gg, Dd, Hd, Dd, Hd, Hd, Dd, Dd, Dd, Dd, Hd, Md, Hd
Ql, Uu, Ql, Ur, Ql, Uu, Ql, Uu, Xu, Xu, Md^Xm, Md, Md^Xm, Md^Xm, Md, Md, Hd, Md, Dd, Gs, Gg^Vh, Rd, Rd, Rd, Hd, Md, Md^Xm, Md, Md, Dd, Gg, Gg, Gg, Rd, Gs, Gg^Vh, Gg, Gg, Gg, Dd, Dd, Dd, Dd, Dd, Hd, Md, Dd, Hd, Dd, Hd, Md^Xm, Md
Ur, Uu^Vu, Ur, Uu, Ur, Uu, Ql^Bs\, Ql, Xu, Md, Md, Md^Xm, Md^Xm, Md, Dd, Dd, Gs, Dd, Dd, Dd, Gs, Gg, Rd, Gs, Hd, Hd, Md, Md^Xm, Md^Xm, Dd, Dd^Do, Gs, Gs, Gs, Gs, Gg, Gg, Dd, Dd, Hd, Dd, Ss, Rd, Rd, Rr^Vd, Hd, Dd, Ss, Dd, Hd, Md^Xm, Md
Ql, Uu, Ql^Bs|, Ql, Ur, Ql, Ql, Ur, Ql, Xu, Hd, Md, Md, Md, Rd, Rd, Rd, Gs, Rd, Gs, Re, Re, Rd, Gs, Gs, Hd, Md, Md^Xm, Md^Xm, Md, Hd, Dd, Dd, Dd, Dd, Dd, Dd, Dd, Rd, Dd, Hd, Dd, Rd, Dd, Dd, Dd, Hd, Dd, Dd^Dc, Hd, Md^Xm, Hd
Uu, Ql, Ur, Ql, Ur, Ur, Ur, Uu, Uu, Xu, Dd, Hd, Hd, Dd, Ss, Gg^Vh, Gg, Rd, Gg, Rd, Rd, Rd, Gg, Rd, Gg^Vh, Hd, Md^Xm, Md^Xm, Md^Xm, Md, Hd, Hd, Md, Hd, Hd, Dd, Dd, Hd, Dd, Dd, Rd, Rd, Dd, Hd, Dd, Dd, Dd, Dd, Dd, Md^Xm, Hd, Hd
Uu^Tf, Uu, Uu, Uu^Vu, Uu, Uh, Uu, Uu^Vu, Ql, Xu, Xu, Hd, Dd, Ss, Dd^Do, Gs, Gs, Gg, Ww, Gg^Vh, Dd^Do, Ww, Dd^Do, Gg, Md, Md, Md^Xm, Md^Xm, Md, Md, Hd, Md, Md, Hd, Dd, Dd, Dd^Do, Dd, Ss, Dd, Dd, Rd, Rd, Rr^Vd, Dd, Hd, Dd, Dd, Hd, Md^Xm, Md, Hd
Xu, Xu, Xu, Xu, Xu, Xu, Xu, Ql, Ql, Ql, Ql, Xu, Xu, Dd, Dd, Dd, Gs, Ww, Dd, Ww, Ss, Ss, Dd, Ww, Ww, Md, Md^Xm, Md, Dd, Dd^Do, Dd, Dd, Dd, Dd, Dd, Dd, Dd, Ss, Ss, Dd, Dd, Dd, Dd, Ss, Dd, Dd, Dd, Dd, Hd, Md, Md, Hd
Xv, Xv, Xv, Xv, Xv, Xv, Xv, Xv, Xv, Xv, Xv, Xv, Xv, Xv, Xv, Xv, Xv, Xv, Xv, Xv, Xv, Xv, Xv, Xv, Xv, Xv, Xv, Xv, Xv, Xv, Xv, Xv, Xv, Xv, Xv, Xv, Xv, Xv, Xv, Xv, Xv, Xv, Xv, Xv, Xv, Xv, Xv, Xv, Xv, Xv, Xv, Xv
Xv, Xv, Xv, Xv, Xv, Xv, Xv, Xv, Xv, Xv, Xv, Xv, Xv, Xv, Xv, Xv, Xv, Xv, Xv, Xv, Xv, Xv, Xv, Xv, Xv, Xv, Xv, Xv, Xv, Xv, Xv, Xv, Xv, Xv, Xv, Xv, Xv, Xv, Xv, Xv, Xv, Xv, Xv, Xv, Xv, Xv, Xv, Xv, Xv, Xv, Xv, Xv
Xv, Xv, Xv, Xv, Xv, Xv, Xv, Xv, Xv, Xv, Xv, Xv, Xv, Xv, Xv, Xv, Xv, Xv, Xv, Xv, Xv, Xv, Xv, Xv, Xv, Xv, Xv, Xv, Xv, Xv, Xv, Xv, Xv, Xv, Xv, Xv, Xv, Xv, Xv, Xv, Xv, Xv, Xv, Xv, Xv, Xv, Xv, Xv, Xv, Xv, Xv, Xv
Xv, Xv, Xv, Xv, Xv, Xv, Xv, Xv, Xv, Xv, Xv, Xv, Xv, Xv, Xv, Xv, Xv, Xv, Xv, Xv, Xv, Xv, Xv, Xv, Xv, Xv, Xv, Xv, Xv, Xv, Xv, Xv, Xv, Xv, Xv, Xv, Xv, Xv, Xv, Xv, Xv, Xv, Xv, Xv, Xv, Xv, Xv, Xv, Xv, Xv, Xv, Xv
Xv, Xv, Xv, Xv, Xv, Xv, Xv, Xv, Xv, Xv, Xv, Xv, Xv, Xv, Xv, Xv, Xv, Xv, Xv, Xv, Xv, Xv, Xv, Xv, Xv, Xv, Xv, Xv, Xv, Xv, Xv, Xv, Xv, Xv, Xv, Xv, Xv, Xv, Xv, Xv, Xv, Xv, Xv, Xv, Xv, Xv, Xv, Xv, Xv, Xv, Xv, Xv
Xv, Xv, Xv, Xv, Xv, Xv, Xv, Xv, Xv, Xv, Xv, Xv, Xv, Xv, Xv, Xv, Xv, Xv, Xv, Xv, Xv, Xv, Xv, Xv, Xv, Xv, Xv, Xv, Xv, Xv, Xv, Xv, Xv, Xv, Xv, Xv, Xv, Xv, Xv, Xv, Xv, Xv, Xv, Xv, Xv, Xv, Xv, Xv, Xv, Xv, Xv, Xv
Xv, Xv, Xv, Xv, Xv, Xv, Xv, Xv, Xv, Xv, Xv, Xv, Xv, Xv, Xv, Xv, Xv, Xv, Xv, Xv, Xv, Xv, Xv, Xv, Xv, Xv, Xv, Xv, Xv, Xv, Xv, Xv, Xv, Xv, Xv, Xv, Xv, Xv, Xv, Xv, Xv, Xv, Xv, Xv, Xv, Xv, Xv, Xv, Xv, Xv, Xv, Xv
