Xv, Xv, Xv, Xv, Xv, Xv, Xv, Xv, Xv, Xv, Xv, Xv, Xv, Xv, Xv, Xv, Xv, Xv, Xv, Xv, Xv, Xv, Xv, Xv, Xv, Xv, Xv, Xv, Xv, Xv, Xv, Xv, Xv, Xv, Xv, Xv, Xv, Xv, Xv, Xv, Xv, Xv, Xv, Xv, Xv, Xv, Xv, Xv, Xv, Xv, Xv, Xv
Xv, Xv, Xv, Xv, Xv, Xv, Xv, Xv, Xv, Xv, Xv, Xv, Xv, Xv, Xv, Xv, Xv, Xv, Xv, Xv, Xv, Xv, Xv, Xv, Xv, Xv, Xv, Xv, Xv, Xv, Xv, Xv, Xv, Xv, Xv, Xv, Xv, Xv, Xv, Xv, Xv, Xv, Xv, Xv, Xv, Xv, Xv, Xv, Xv, Xv, Xv, Xv
Xv, Xv, Xv, Xv, Xv, Xv, Xv, Xv, Xv, Xv, Xv, Xv, Xv, Xv, Xv, Xv, Xv, Xv, Xv, Xv, Xv, Xv, Xv, Xv, Xv, Xv, Xv, Xv, Xv, Xv, Xv, Xv, Xv, Xv, Xv, Xv, Xv, Xv, Xv, Xv, Xv, Xv, Xv, Xv, Xv, Xv, Xv, Xv, Xv, Xv, Xv, Xv
Xv, Xv, Xv, Xv, Xv, Xv, Xv, Xv, Xv, Xv, Xv, Xv, Xv, Xv, Xv, Xv, Xv, Xv, Xv, Xv, Xv, Xv, Xv, Xv, Xv, Xv, Xv, Xv, Xv, Xv, Xv, Xv, Xv, Xv, Xv, Xv, Xv, Xv, Xv, Xv, Xv, Xv, Xv, Xv, Xv, Xv, Xv, Xv, Xv, Xv, Xv, Xv
Xv, Xv, Xv, Xv, Xv, Xv, Xv, Xv, Xv, Xv, Xv, Xv, Xv, Xv, Xv, Xv, Xv, Xv, Xv, Xv, Xv, Xv, Xv, Xv, Xv, Xv, Xv, Xv, Xv, Xv, Xv, Xv, Xv, Xv, Xv, Xv, Xv, Xv, Xv, Xv, Xv, Xv, Xv, Xv, Xv, Xv, Xv, Xv, Xv, Xv, Xv, Xv
Xv, Xv, Xv, Xv, Xv, Xv, Xv, Xv, Xv, Xv, Xv, Xv, Xv, Xv, Xv, Xv, Xv, Xv, Xv, Xv, Xv, Xv, Xv, Xv, Xv, Xv, Xv, Xv, Xv, Xv, Xv, Xv, Xv, Xv, Xv, Xv, Xv, Xv, Xv, Xv, Xv, Xv, Xv, Xv, Xv, Xv, Xv, Xv, Xv, Xv, Xv, Xv
Ds, Xv, Ds, Xv, Ds, Xv, Ds, Xv, Ss, Xv, Ss, Xv, Ds, Xv, Ss, Xv, Ss, Xv, Ss, Xv, Ss, Xv, Ds, Xv, Dd, Xv, Dd, Xv, Dd, Xv, Dd, Xv, Dd, Xv, Dd, Xv, Dd, Xv, Dd, Xv, Dd, Xv, Hd, Xv, Md, Xv, Md, Xv, Md, Xv, Md, Xv
Ss, Ds, Ds, Ds, Ds, Ds, Gs^Ft, Ds, Ss, Ss, Ds, Ss, Ds, Ds, Ss, Ss, Ss, Ss, Ds, Ss, Ss, Ds, Dd, Dd, Hd, Dd, Dd, Dd, Hd, Dd, Dd^Vdt, Hd, Dd, Dd, Dd, Hd, Ds, Hd, Dd, Dd, Dd, Hd, Md, Md, Md, Md, Md, Md, Md, Md, Md^Xm, Md^Xm
Ds, Ss, Ss, Ss, Ss, Ss, Gs^Ft, Gs^Ft, Ss, Ds, Ss, Ss, Ss, Ss, Gs^Ft, Gs^Ft, Gs^Ft, Ss, Ds, Ds, Gs^Ft, Ds, Ds, Hd, Dd, Dd, Dd, Hd, Ds, Rd, Ds, Dd, Dd, Hd, Dd, Dd, Hd, Ds, Dd^Dc, Md, Dd, Hd, Md, Md, Md, Md, Md, Rd, Rr^Vd, Md^Xm, Md^Xm, Md^Xm
Ss, Gs^Ft, Ss, Ds, Ds, Ss, Ss, Ss, Gs^Ft, Ss, Ds, Ss^Vhs, Gs, Ss, Ss, Ss, Ss, Ss, Gs^Ft, Gs^Ft, Ss, Gs^Ft, Gs, Ds, Ds, Dd, Ds, Dd, Ds, Dd, Dd, Ds, Dd, Ds, Dd^Vdt, Dd^Dr, Dd, Dd, Dd, Dd, Dd, Hd, Hd, Hd, Hd, Hd, Hd, Hd, Hd, Md^Xm, Md^Xm, Md^Xm
Ss, Ds, Ss, Ds, Gs, Ss^Vhs, Ss, Gs, Ss, Ss, Ss, Ss, Ss, Ds, Ss, Gs^Ft, Rd, Ds, Ds, Ss, Gs^Ft, Gs^Ft, Gs^Ft, Gs, Gs, Ds, Ds, Ds, Dd^Vdt, Dd, Dd, Hd, Dd, Rd, Ds, Dd, Dd, Hd, Ds, Hd, Ds, Dd, Rd, Rr^Vd, Hd, Hd, Md, Md, Md^Xm, Md^Xm, Md^Xm, Md^Xm
Gs, Ss, Gs^Ft, Ss, Ss, Ss, Gs^Ft, Ss, Ds, Ss, Gs^Ft, Gs, Ss, Ss, Ds, Ss, Ss, Gs^Ft, Gs^Ft, Gs^Ft, Gs, Gg^Ve, Gs, Gs^Ft, Ss, Gs^Ft, Gs, Rd, Rd, Ds, Dd, Dd, Gs^Ft, Gs^Ft, Ww, Ds, Dd, Dd, Hd, Ds, Dd, Dd, Dd, Hd, Hd, Md, Md^Xm, Md^Xm, Md^Xm, Md^Xm, Md^Xm, Md^Xm
Gs, Ds, Ss, Ss, Ds, Ss, Gs, Ss, Ss, Gs^Ft, Gs^Ft, Ss, Ss, Ds, Ds, Ss, Gs, Gs, Gs^Ft, Ss, Gs^Ft, Gs^Ft, Gs^Ft, Ds, Gs, Gs^Ft, Ds, Gs, Ds, Ds, Dd, Dd, Gg, Dd^Do, Dd, Ds, Hd, Dd, Md, Dd, Dd, Hd, Dd, Dd, Dd, Md, Md, Md, Md, Md^Xm, Md, Md^Xm
Gg, Gs, Gs, Ss, Ds, Ds, Ss, Ss, Ss, Ss, Rd, Ds, Ss, Gs^Ft, Ss, Gs^Ft, Gs^Ft, Gs^Ft, Hh, Ds, Gs^Ft, Gs, Gs, Gs^Ft, Gs^Ft, Rd, Rd, Gs, Gs, Ds, Dd, Dd, Dd, Gs^Ft, Dd, Dd, Dd, Md, Md, Dd^Do, Dd, Dd, Hd, Dd, Dd, Dd, Hd, Md, Md, Md, Md, Md
Gg, Gg, Gs, Ds, Ds, Ds, Ss, Gs^Ft, Ss, Rd, Ds, Ss, Gs^Ft, Ds, Ss, Ss, Gg^Ve, Gs, Gs^Ft, Gs^Ft, Ss, Ss, Gs^Ft, Gs^Ft, Ss, Gs^Ft, Gs, Gs^Ft, Gs, Ds, Ds, Dd, Hd, Dd, Dd, Hd, Dd, Hd, Dd, Hd, Hd, Dd, Dd, Dd, Md, Dd, Dd, Hd, Hd, Hd, Hd, Hd
Gg, Gg, Gg^Vh, Gs, Gs, Ss, Ss, Ss, Gs, Ds, Gs^Ft, Ss, Ss, Rd, Rd, Gs^Ft, Gs^Ft, Gs^Ft, Gs^Ft, Gs^Ft, Gs^Ft, Ss, Ds, Ss, Gs, Gs^Ft, Gg^Ve, Gs^Ft, Hh, Gs, Ds, Dd, Dd, Dd, Hd, Ds, Dd, Hd, Ds, Dd, Dd, Dd, Dd, Dd, Dd, Dd, Dd, Ds, Wo, Wo, Wo, Ds
Gg, Gg, Gg, Gg, Wo, Wo, Gs, Gs, Gs, Gs, Gg, Gs, Gs, Gs^Ft, Gs, Gs, Gs^Ft, Ss, Ds, Gs^Ft, Gs^Ft, Ss, Gs^Ft, Gs^Ft, Gs^Ft, Gs, Gs^Ft, Rp, Gs, Gs, Hd, Dd, Dd, Dd, Dd, Dd, Dd, Dd, Dd, Dd, Dd, Dd^Dc, Dd, Hd, Dd, Hd, Dd, Ds, Wo, Wo, Ds, Ds
Gg, Gg, Hh^Fp, Gg, Wo^Bw\, Hh, Gg, Gg^Vh, Gg, Gs^Ft, Gg, Hh, Gs, Gs, Gs, Gs^Ft, Gs^Ft, Gs^Ft, Gs^Ft, Rd, Gs^Ft, Rd, Gs^Ft, Gs^Ft, Hh, Gs^Ft, Rp, Rp, Gs^Ft, Gs, Gs, Ds, Dd, Hd, Dd, Dd, Dd, Hd^Dr, Dd^Vda, Dd, Dd, Dd, Dd, Hd, Dd, Dd, Dd, Wo, Wo, Wo, Ds, Ds
Gg, Hh, Wo, Ww, Re^Gvs, Gg, Gs, Hh, Gg, Gs, Gs, Gg, Gs^Ft, Hh, Ss, Gs, Gs, Gs, Gs^Ft, Gs^Ft, Gg^Ve, Gs^Ft, Gs^Ft, Hh, Gs^Ft, Gs, Rp, Hh, Gg, Gg, Wo, Ds, Dd, Dd, Dd, Hd, Hd, Dd, Rd, Dd, Hd, Dd, Hd, Dd, Dd, Dd, Dd, Wo, Wo, Wo, Wo, Ds
Gg, Hh^Fp, Wo, Re^Gvs, Gs^Fp, Gg, Hh, Gs, Hh^Fdw, Gg, Gg, Gg, Hh, Ss, Wwf, Gs, Gg, Gs, Gs^Ft, Gs, Gs, Gs^Ft, Gs, Gs^Ft, Gs, Gs^Ft, Rp, Gg, Ww, Gg, Wo, Ds, Ds, Dd, Dd, Dd, Dd, Dd, Dd, Dd, Dd, Hd, Dd, Dd, Rd, Hd, Wo, Wo, Ds, Wo, Wo, Wo
Gg, Gg, Wo, Re^Gvs, Hh, Gs^Fp, Hh, Gs, Gg, Hh, Gg, Gg, Gs, Gs, Gg, Hh, Gg, Gg, Gg, Gs, Hh, Hh, Hh, Gs, Gg, Gs, Ww, Ww^Bw\, Rr, Ww, Ww, Ww, Ww, Ds, Dd, Dd, Hd, Dd, Hd, Dd, Hd, Ds, Dd, Dd, Dd, Dd^Vda, Wo, Wo, Wo, Wo, Wo, Wo
Ww, Wwf, Re^Gvs, Hh, Gg, Gg^Vc, Gg, Gg, Rd, Gg, Re, Re, Re, Gg^Vh, Rp, Gg, Gg, Re^Gvs, Re^Gvs, Hh, Hh, Hh, Mm^Xm, Hh, Gg, Gg, Wo, Hh, Rr, Gg, Gg^Vh, Gg, Gg, Ds, Dd, Hd, Dd, Dd, Dd, Dd^Do, Gs^Ft, Dd, Hd, Dd, Dd, Ds, Ds, Wo, Wo, Wo, Wo, Wo
Hh, Gg, Gg, Hh, Rd, Rd, Rd, Rd, Hh, Rd, Gg, Gg, Gg, Gs^Fp, Gg, Rp, Rp, Re^Gvs, Hh, Hh, Mm^Xm, Mm^Xm, Wo, Hh, Wo, Wo, Gg, Gg, Gg, Rr, Gg, Gg, Hh, Ds, Dd, Hd, Dd, Rd, Dd, Dd, Hd, Dd, Rd, Hd, Dd, Dd, Ds, Wo, Wo, Wo, Dd, Wo
Hh, Gs^Fp, Rd, Rd, Hh, Gg, Gg^Vc, Hh, Hh, Gg, Gs^Fp, Gg, Hh, Gg, Hh, Gg, Gg, Gg^Vh, Hh, Mm^Xm, Mm, Mm, Hh, Wo, Gg^Vh, Gg, Gg, Gg, Gs, Rr, Re^Gvs, Hh, Hh, Gs, Ds, Dd, Rd, Dd^Vda, Hd, Hd, Md, Hd, Dd^Vda, Dd, Hd, Dd, Dd, Ds, Wo, Wo, Wo, Wo
Hh, Gs^Fp, Rd, Re^Gvs, Re^Gvs, Hh, Gg, Gg, Re^Gvs, Re^Gvs, Gg, Hh, Hh, Hh, Gg, Gg, Hh, Hh, Mm, Mm^Xm, Mm, Hh, Gg, Gg, Gg, Gg, Gs^Fp, Gs^Fp, Gs, Rr, Re^Gvs, Re^Gvs, Hh, Gs, Ds, Hd, Hd, Dd, Hd, Md, Md, Hd, Dd, Dd, Dd, Dd, Dd, Rd, Ds, Wo, Wo, Wo
Gg, Gg, Rd, Re^Gvs, Gg, Hh, Gg, Hh, Hh, Gg, Gg, Gg^Vc, Gg, Gg, Hh^Fdw, Gg, Hh, Hh, Mm^Xm, Mm^Xm, Hh, Hh, Gg, Gg, Gg, Gg, Re^Gvs, Re^Gvs, Re^Gvs, Rr, Gg, Re^Gvs, Gg^Vh, Gs, Gs, Ds, Dd, Dd, Hd, Hd, Hd, Ds, Ds, Dd, Dd, Dd, Ds, Dd^Vda, Wo, Wo, Wo, Ds
Gg, Rd, Gg, Gg^Vc, Hh, Gg, Gg, Gs^Fdw, Hh, Hh, Re^Gvs, Re^Gvs, Gg, Gg, Hh^Fdw, Hh, Mm, Mm, Mm^Xm, Mm, Hh, Gg, Gg, Hh, Gg, Gg, Gg, Re^Gvs, Rr, Rr, Gg, Gg, Gs, Gs, Hh, Ds, Ds, Dd, Dd, Hd, Dd, Ds, Hd, Dd, Hd, Dd, Ds, Wo, Wo, Wo, Wo, Ds
Re, Re, Gg, Hh, Gg, Gg, Gs^Fp, Hh, Gg, Gg, Gs^Fp, Re^Gvs, Hh, Hh^Fdw, Hh^Fdw, Mm, Mm, Mm^Xm, Mm, Hh, Gg^Vh, Gg, Rp, Gg, Gg, Gg^Vh, Rp, Rr, Rr, Gs^Fp, Gg, Re^Gvs, Re^Gvs, Gs, Gs, Gs, Ds, Hd, Dd, Hd, Rd, Dd^Vda, Dd, Dd, Ds, Dd, Ds, Wo, Wo, Wo, Wo, Wo
Gg, Gg, Gg, Gg, Gg, Hh, Ww, Gs^Fp, Hh, Gg, Gs^Fp, Gg, Gg^Vc, Gg, Hh, Mm, Mm^Xm, Mm^Xm, Hh, Hh, Gg, Rp, Re^Gvs, Rp, Rp, Rp, Ww, Re^Gvs, Re^Gvs, Rr, Gg^Vh, Re^Gvs, Gg, Gg, Gg, Gg, Gs, Ds, Ds, Dd, Dd, Hd, Dd, Ds, Ww, Ds, Ds, Ds, Wo, Wo, Wo, Wo
Gg, Gg, Gs^Fdw, Hh, Hh, Gs^Fp, Ww, Ww, Gg, Gg, Re^Gvs, Gg, Gg, Hh, Hh, Mm, Mm^Xm, Hh, Gg, Gg, Hh, Re^Gvs, Gs^Fp, Gg, Re^Gvs, Re^Gvs, Ww, Ww, Rr, Rr, Gg, Gg, Gg, Hh, Gg, Gs, Gs, Gs, Gs, Ds, Hd, Ds, Gs^Ft, Gs^Ft, Dd^Do, Ww, Ds, Ds, Wo, Wo, Wo, Wo
Re, Gg, Gg, Hh, Gg, Gg, Gg, Gs^Fp, Gg, Re^Gvs, Re^Gvs, Gs^Fmw, Gg, Gg, Hh, Hh, Mm, Mm, Gg, Hh, Hh, Gg, Gg, Gg, Gg, Re^Gvs, Hh, Gs, Rr, Hh, Re^Gvs, Gg, Gg, Gg, Gs, Gg, Gs, Gs, Gs, Ds, Dd, Dd, Dd, Gs^Ft, Gs, Ww, Ds, Wo, Wo, Wo, Wo, Wo
Re, Gs^Fp, Re^Gvs, Re^Gvs, Gg, Hh, Gg, Gg, Hh, Gg, Gg, Gg, Gg, Gg, Hh, Mm, Mm, Mm, Hh, Gg, Gg, Gg, Gg, Gg, Re^Gvs, Mm, Hh, Gg, Rr, Re^Gvs, Re^Gvs, Gg, Gs^Fp, Gg, Hh, Hh, Gs, Gs, Gs, Gs, Gs, Ds, Ds, Ds, Ds, Ds, Ds, Wo, Wo, Wo, Wo, Wo
Re, Gg, Gg, Re^Gvs, Gg, Gg, Gg, Gg, Gg, Hh, Gg, Hh, Gs^Fmw, Gs^Fmw, Gg, Hh, Mm, Mm^Xm, Mm, Gg^Vh, Gg, Gg, Gg, Re^Gvs, Re^Gvs, Re^Gvs, Gg, Gg, Rp, Gg, Gg, Gg, Gg, Gg, Hh, Hh, Gs, Gs, Gg, Gs, Gs, Gs, Gs, Ds, Gs, Ds, Ds, Ds, Wo, Wo, Wo, Wo
Gg, Re, Gg^Vh, Gg, Gg, Gs^Fp, Gg, Hh, Gg, Gg, Gs^Fmw, Gg, Mm, Gs^Fmw, Gg, Gg, Hh, Mm^Xm, Mm^Xm, Hh, Gg, Re^Gvs, Re^Gvs, Gg, Gg, Gg, Gg, Rp, Gg, Gg, Gg, Gg, Gg, Gg, Gs, Gs, Re^Gvs, Re^Gvs, Re^Gvs, Gg, Gs, Gs, Gs, Gs, Re^Gvs, Gs, Gg, Gg, Wo, Wo, Wo, Wo
Rp, Rp, Rp, Gg, Hh, Gg, Gg, Gg, Gg, Gg, Gs^Fmw, Mm, Mm, Mm, Gg^Vh, Gg, Gg, Hh, Mm^Xm, Mm, Hh, Re^Gvs, Re^Gvs, Gg, Gg, Gg, Gg, Rp, Rp, Gg, Gg, Gg, Gg^Vh, Gg, Gg, Gs, Re^Gvs, Re^Gvs, Gg, Gg, Hh, Gs, Gs, Re^Gvs, Re^Gvs, Gg, Rd, Gg^Vh, Wo, Wo, Wo, Wo
Gs^Fms, Gg, Gg, Rp, Rp, Gg, Gg, Gg, Gg, Gs^Fmw, Gg, Hh, Hh, Hh, Gg, Rp, Gg, Hh, Mm, Mm^Xm, Mm, Hh, Gg, Gg, Hh, Hh, Hh, Gg^Vh, Gg, Rp, Rp, Rp, Gg, Gg, Gg, Gg, Gg, Gg, Gg^Vh, Hh, Gs^Fp, Gs, Rd, Gs, Rd, Rd, Gg, Wo, Wo, Wo, Wo, Wo
Re^Gvs, Gg, Hh, Gg, Gg, Gg^Vh, Gg, Gg, Re^Gvs, Gg, Gg, Gg, Gg, Gg, Gg, Rp, Rp, Hh, Hh, Mm^Xm, Mm^Xm, Ww, Ww, Gg, Hh, Hh, Gg, Gg, Wo, Gg, Re, Rp, Rd, Rd, Ww, Gg, Rd, Rd, Gg, Rd, Rd, Rd, Gg, Rd, Gg, Gg, Re^Gvs, Wo, Wo, Wo, Wo, Wo
Re^Gvs, Gg, Gg, Gg, Gg, Gg, Gg, Gg, Re^Gvs, Re^Gvs, Gg, Gg, Gg, Gg, Gg, Hh, Rp, Gg, Gg^Vh, Hh, Hh, Hh, Gg, Ww, Wo, Wo, Wo, Wo, Re^Gvs, Wo, Ww, Ww^Bw|, Wwf, Ww, Wo, Ww, Gg, Gg, Gg, Gg, Gg, Gs^Fp, Gg, Rd, Rd, Hh, Gg, Re^Gvs, Wo, Wo, Wo, Wo
Gg, Gg^Vh, Gg, Gs^Fms, Gg, Gg, Gg, Re^Gvs, Re^Gvs, Re^Gvs, Gs^Fms, Gg, Gg, Gg^Vh, Hh, Gg, Gg, Rp, Gg, Gg, Gg, Gg, Gg, Gg, Gg, Gg, Re^Gvs, Re^Gvs, Hh, Rd, Rp, Rp, Gg, Ww, Ww, Ww, Gg, Gg, Hh, Re^Gvs, Re^Gvs, Gg^Vh, Gg, Gg, Rd, Gs^Fp, Gg, Gg^Vh, Wo, Wo, Wo, Wo
Gg, Gg, Gg, Gg, Gg, Gg, Gs^Fms, Gg, Gg, Gg, Gg, Gg, Gg, Gg, Gg, Gg, Gg, Rp, Gg, Gg, Gg, Gg, Gg, Gg, Gs^Fms, Gs^Fms, Gg, Re^Gvs, Gg^Vh, Gg, Rp, Gg, Gg, Gg, Gg, Ww, Gg, Gg, Re^Gvs, Re^Gvs, Re^Gvs, Gg, Gg, Hh, Rd, Gg, Gg, Wo, Wo, Wo, Gg, Wo
Hh^Fms, Gg, Gg, Gg, Gg, Hh^Fms, Hh, Gg, Gg, Gg, Gg, Gg, Gg, Gg, Gg, Gg, Gs^Fms, Rp, Gg, Gg, Gg, Hh, Hh, Gg, Re^Gvs, Gs^Fms, Re^Gvs, Gg, Gg, Gg, Rp, Gg, Gs^Fms, Gg, Gg, Ww, Ww, Gg, Re^Gvs, Re^Gvs, Hh, Gg, Hh^Fp, Gg, Gg, Rd, Gg, Wo, Wo, Wo, Wo, Wo
Gs^Fms, Gg, Gg, Gg, Gs^Fds, Gg, Gg, Gg, Gg, Hh, Gg, Gg, Hh, Gg, Gg, Gs^Fds, Rp, Rp, Gg, Gs^Fds, Gs^Fds, Hh, Gg, Re^Gvs, Re^Gvs, Re^Gvs, Gg, Gg, Re^Gvs, Gg, Gg, Rp, Gg, Gg, Hh, Gg, Wo, Hh, Gg, Hh^Fmw, Mm, Mm, Hh, Gg, Hh^Fp, Re, Wo, Wo, Wo, Wo, Wo, Wo
Hh, Gs^Fms, Gg, Gg, Gg, Gg, Gg, Gg, Gg, Gs^Fms, Gg, Gs^Fds, Hh^Fds, Gs^Fds, Hh, Gs^Fds, Rp, Gs^Fds, Gg, Gs^Fds, Gg, Gs^Fds, Hh, Gg, Rd, Re^Gvs, Gg, Gg, Hh, Re^Gvs, Gg, Rp, Rp, Gg, Gg, Gg, Gs^Fms, Wo, Gg, Hh^Fmw, Mm, Hh^Fmw, Hh, Gg, Gg, Re, Wo, Wo, Hh, Wo, Wo, Wo
Mm, Hh, Gs^Fms, Gg, Hh, Hh, Hh, Gg, Gg, Gg, Gs^Fds, Gg^Ve, Gs^Fms, Gg^Fet, Gg, Gs^Fds, Rp, Gg^Ve, Gs^Fms, Gg, Hh, Gg, Re, Gg, Rd, Gg^Vh, Gg, Hh, Re^Gvs, Gg, Gg, Gg, Gg^Vh, Gs^Fms, Gg, Gg, Gg, Wo, Re^Gvs, Gg, Gg, Gg, Gg^Vc, Gg, Re, Re, Wo, Wo, Hh^Fp, Wo, Wo, Wo
Mm, Mm, Mm, Gg, Mm, Mm, Mm, Gg, Gg, Gs^Fds, Hh, Gg, Hh, Gs^Fds, Rp, Rp, Gs^Fds, Gs^Fms, Gs^Fms, Re, Re, Re, Gg, Re, Re, Gg, Gg, Re^Gvs, Re^Gvs, Gg, Gs^Fms, Gg, Re, Gg, Gg, Gg, Wwf, Ww, Re^Gvs, Re^Gvs, Gg, Hh, Hh, Gg, Re, Gg, Gg, Wo, Wo, Hh^Fp, Wo, Wo
Mm, Mm, Mm, Mm^Vhh, Gg, Mm, Gs^Fds, Gg, Gg, Gs^Fds, Gg, Gs^Fds, Gs^Fds, Gs^Fms, Rp, Gs^Fds, Gg^Fet, Hh, Gg, Gg, Gg, Gs^Fms, Gg, Hh, Re, Gg, Gg, Gg, Gg, Gg, Gg, Gg, Re, Hh, Hh, Ww, Gs^Fms, Gg, Hh, Gg, Re, Gg, Re, Gg, Re, Gg, Gg, Wo, Wo, Wo, Wo, Wo
Mm^Xm, Hh, Hh, Hh, Hh, Hh^Fds, Gg, Hh, Gg, Gg, Gg, Gs^Fds, Rp, Gg^Ve, Hh, Gs^Fds, Gs^Fds, Gs^Fds, Gg, Gg, Hh, Gg, Gg, Gg, Rd, Re, Re, Re, Re, Gg, Re, Re, Gs^Fms, Gg, Wo, Wo, Re^Gvs, Hh, Gg^Vc, Re, Gg, Re, Hh, Re, Gg, Gg^Vc, Gg, Gg, Wo, Wo, Wo, Wo
Hh^Fds, Mm^Xm, Mm, Mm, Mm, Mm, Mm^Vhh, Gg, Hh, Gg, Gg, Rp, Gs^Fms, Gg, Gs^Fds, Gg, Gg, Gg, Gg, Gg, Gs^Fms, Hh, Gg, Gg^Vh, Rd, Gg, Hh, Hh, Gg, Re, Gg, Gg, Gg, Gg, Wo, Re^Gvs, Re^Gvs, Gg, Gg, Hh, Hh, Gg, Gg, Re, Re, Hh, Hh, Gg, Wo, Wo, Wo, Wo
Mm, Mm, Mm, Mm, Mm, Mm, Mm, Mm, Hh^Fms, Hh, Gg, Rp, Hh, Gs^Fds, Gs^Fds, Gg, Gg, Gg, Gg, Gg, Gg, Gg, Gg, Gg, Rd, Gg, Gg, Hh, Re^Gvs, Rd, Gg, Gs^Fms, Gg, Gg, Wwf, Re^Gvs, Gg, Gg, Gs^Fmw, Gg, Re^Gvs, Re^Gvs, Hh, Hh, Re, Hh, Gg^Vc, Wo, Wo, Wo, Wo, Wo
Mm, Mm, Mm^Xm, Mm^Xm, Mm, Mm, Mm, Mm, Mm^Xm, Hh, Hh, Rp, Rp, Gs^Fms, Gg, Gg, Hh, Gg, Mm, Hh, Gg, Gg, Gg, Rd, Hh, Gg, Re^Gvs, Re^Gvs, Re^Gvs, Gg^Vh, Gg, Gg, Hh, Gs^Fms, Wwr, Gg, Hh, Hh, Gg, Gg, Gg, Re^Gvs, Gg^Vc, Hh, Re, Gg, Gg, Wo, Wo, Wo, Wo, Wo
Gg, Mm, Mm, Mm, Mm, Mm, Mm, Mm^Xm, Mm, Mm, Hh, Gg, Gg, Rp, Rp, Gg, Gg, Mm, Mm, Mm, Hh, Gg, Rd, Rd, Hh, Hh, Hh, Re^Gvs, Hh, Gg, Hh, Hh, Mm, Ww, Gg, Gg, Gg, Hh, Gs^Fmw, Hh, Gg, Gs^Fmw, Gg, Re, Gg, Gs^Fmw, Wo, Wo, Wo, Wo, Wo, Wo
Hh, Hh, Mm, Hh, Hh, Mm, Mm, Mm^Xm, Hh, Hh^Fds, Gg, Gg, Hh^Fms, Gs^Fds, Rp, Hh, Hh^Fms, Hh, Hh, Hh, Hh, Rd, Gg, Hh, Hh, Mm, Mm, Mm^Xm, Mm, Hh, Mm, Mm, Hh, Wwf, Gs^Fp, Gs^Fmw, Gg, Gg, Gg, Gg, Gs^Fmw, Gg, Gg, Re, Gg, Wo, Wo, Wo, Wo, Wo, Wo, Wo
Hh^Fds, Mm, Mm^Xm, Mm, Mm, Mm^Vhh, Gg, Mm, Gg, Gg, Hh, Hh, Gg, Rp, Hh, Hh, Gg, Gg, Gg, Hh, Rp, Rp, Gg, Gg, Gg, Hh, Hh, Mm, Hh, Hh, Hh, Hh, Hh, Ww, Gg^Ve, Gs^Fp, Gs^Fp, Gg, Hh, Hh, Gs^Fmw, Gs^Fmw, Re, Re, Hh, Wo, Wo, Wo, Wo, Wo, Wo, Wo
Mm, Mm^Xm, Mm, Mm, Mm, Mm, Hh, Hh, Hh^Fds, Gg, Gg, Gs^Fds, Rp, Rp, Rp, Re^Gvs, Re^Gvs, Re^Gvs, Gg, Gg, Rp, Gg, Gg, Gg, Gg^Vh, Hh, Hh, Hh, Gg, Gg, Gg^Vh, Re^Gvs, Re^Gvs, Wo, Gs^Fp, Rd, Rd, Gs^Fmw, Hh^Fp, Mm, Rd, Rd, Hh, Hh, Wo, Wo, Wo, Wo, Wo, Mm^Xm, Wo, Wo
Mm^Xm, Mm, Mm, Mm, Rp, Mm, Mm, Mm, Hh, Gg, Gg, Gg, Gg^Vh, Hh, Rp, Re^Gvs, Re^Gvs, Re^Gvs, Gg^Vh, Gg, Rp, Gg, Rp, Rp, Re^Gvs, Rp, Rp, Gg, Rp, Gg, Rp, Gg, Hh^Fp, Wo, Wo, Gs^Fp, Rd, Gs^Fp, Gs^Fmw, Rd, Gg, Gg, Mm, Hh, Hh, Wo, Wo, Wo, Wo, Wo, Wo, Wo
Mm, Mm, Hh^Fds, Mm^Vhh, Rp, Mm, Mm, Mm, Hh^Fds, Gg, Gg, Gg, Gs^Fds, Gg, Mm, Rp, Hh, Re^Gvs, Rp, Rp, Re^Gvs, Rp, Re^Gvs, Re^Gvs, Re^Gvs, Re^Gvs, Gg, Rp, Hh^Fms, Rp, Hh, Hh^Fp, Mm, Hh, Wo, Gs^Fp, Gg^Ve, Gs^Fp, Rd, Rd, Gg, Hh, Mm, Mm, Hh, Wo, Wo, Wo, Wo, Wo, Wo, Wo
Mm^Xm, Hh, Hh, Hh, Rp, Gg, Hh, Hh^Fds, Gg, Gg, Gg, Gg, Gg, Gg, Gg, Rp, Rp, Rp, Gg, Rp, Rp, Re^Gvs, Re^Gvs, Hh, Gg, Re^Gvs, Gg, Rp, Hh, Hh, Mm, Mm, Mm, Mm, Wo, Gs^Fp, Gs^Fms, Rd, Gs^Fp, Gs^Fp, Gs^Fp, Hh, Hh, Hh, Wo, Wo, Wo, Wo, Wo, Wo, Wo, Wo
Mm, Hh^Fds, Gg, Rp, Gg, Gg, Gg, Gs^Fds, Gs^Fds, Gs^Fds, Hh, Gg, Gs^Fds, Gg, Gg, Gg, Gg, Gg, Gg, Gg, Rp, Re^Gvs, Gg, Gg, Gg, Gg, Rp, Rp, Mm, Hh^Fp, Mm, Mm^Xm, Mm^Xm, Wo, Hh, Hh^Fp, Gs^Fms, Rd, Rd, Gg^Ve, Gs^Fp, Gs^Fmw, Gg, Gg, Wo, Wo, Wo, Wo, Wo, Wo, Wo, Wo
Hh, Hh, Gg, Rp, Hh^Fds, Hh^Fds, Gs^Fds, Gg, Gs^Fds, Gg, Gg, Gg, Gg, Gg, Gg, Gg, Gg, Gg, Rd, Rd, Gg, Gg^Vh, Gg, Gg, Gg, Gg, Gg^Vh, Hh, Wo, Hh, Wo, Mm^Xm, Mm^Xm, Mm, Hh, Hh^Fp, Gs^Fp, Gs^Fmw, Rd, Gg, Gg, Hh, Hh, Gg, Gg, Wo, Wo, Wo, Wo, Wo, Wo, Wo
Hh, Gg, Gs^Fds, Rp, Rp, Rp, Gg^Ve, Hh^Fds, Gs^Fds, Gs^Fds, Gg, Gs^Fds, Gs^Fds, Gg, Hh, Re^Gvs, Re^Gvs, Rd, Ww, Ww, Ww, Ds, Ds, Ds, Ds, Gg, Gg, Wo, Gg, Wo, Hh, Mm, Mm^Xm, Mm, Mm, Hh, Gs^Fp, Rd, Gg, Gs^Fp, Gg, Hh, Gg, Gs^Fmw, Gg, Wo, Wo, Wo, Wo, Wo, Wo, Wo
Gs^Fds, Gg, Gs^Fds, Hh^Fds, Hh^Fms, Gs^Fds, Rp, Gs^Fds, Ds, Gg, Gg, Gs^Fds, Gg, Gg, Gg, Re^Gvs, Rd, Rd, Ww, Ww, Gs^Fms, Wo, Wo, Wo, Wo, Gs^Fms, Wo, Wo, Gg, Hh, Hh, Hh, Hh, Mm^Xm, Hh, Hh, Gg^Ve, Rd, Gg, Hh, Gs^Fp, Gs^Fp, Gs^Fp, Gg, Wo, Wo, Wo, Wo, Wo, Wo, Wo, Wo
Gs^Fds, Gg^Ve, Gg, Ds, Gs^Fds, Rp, Gs^Fds, Gs^Fds, Hh, Hh^Fms, Gg, Gg, Hh, Gg, Gg, Gg, Rd, Gg, Gg, Ww, Gs^Fms, Gs^Fms, Gg, Gg, Gg, Wo, Gg, Gg, Gg, Gg, Hh, Mm, Mm, Hh, Hh, Gs^Fp, Gs^Fp, Rd, Hh, Hh, Gg, Gg^Ve, Rp, Wo, Wo, Wo, Wo, Wo, Wo, Wo, Wo, Wo
Gg, Gs^Fds, Gs^Fds, Hh, Gs^Fds, Gg^Ve, Rp, Gg, Gg, Gs^Fds, Gg, Gg, Gg, Gg, Re^Gvs, Gg^Vh, Rd, Gg, Gg, Gg, Gg, Gg, Gg, Gs^Fms, Gg, Gg, Gs^Fp, Hh, Gg, Gg, Hh, Mm, Hh, Hh, Gg, Gs^Fmw, Rd, Rd, Gg, Hh, Gs^Fmw, Gs^Fp, Rp, Wo, Wo, Wo, Wo, Wo, Wo, Wo, Wo, Wo
Gs^Fds, Hh^Fms, Gg, Gs^Fds, Gg^Fet, Gs^Fds, Rp, Gs^Fds, Gs^Fds, Gs^Fds, Gg, Hh, Gs^Fms, Gg, Re^Gvs, Gg, Gg, Rd, Rd, Hh, Rd, Rd, Rd, Gs^Fp, Gg^Ve, Gs^Fp, Gs^Fp, Gs^Fp, Gs^Fmw, Hh, Gg, Hh, Gg, Gs^Fp, Gs^Fmw, Rd, Gg, Gg, Gg, Gg, Gg, Gg, Rp, Gg, Gs^Fp, Wo, Wo, Wo, Wo, Wo, Wo, Wo
Ds, Gs^Fds, Hh^Fds, Gs^Fds, Gs^Fds, Gs^Fms, Rp, Ds, Gs^Fds, Gg, Gg, Gs^Fms, Gg, Gg, Gg, Hh, Gg, Gg, Rd, Rd, Hh, Hh, Gg, Rd, Gs^Fp, Gs^Fp, Hh, Gs^Fp, Gg^Ve, Hh, Gs^Fp, Gs^Fp, Gs^Fp, Gg, Rd, Rd, Gg, Gg, Gg, Gg, Gg, Rp, Gg, Gg, Hh, Gs^Fp, Wo, Wo, Wo, Wo, Wo, Wo
Wo, Ds, Ds, Gg, Hh, Gs^Fms, Rp, Ds, Gg, Gg, Gg, Gg, Gg, Gg, Gs^Fms, Gg, Gg^Vh, Rd, Gg, Gg, Gg, Hh, Gs^Fms, Rd, Rd, Gs^Fp, Gg, Gs^Fp, Rd, Gs^Fp, Gg^Fet, Gs^Fp, Rd, Hh, Rd, Gg, Gs^Fmw, Gg, Gg, Gg, Gg, Rp, Wo, Hh, Gg, Gg, Gg^Vh, Wo, Wo, Wo, Wo, Wo
Rd, Wo, Ds, Gg, Gs^Fds, Hh, Gg, Rp, Gg, Gg, Gg, Gg, Hh, Gg, Re^Gvs, Re^Gvs, Re^Gvs, Gg, Gg, Ds, Ds, Gs, Gs, Gg, Rd, Gg, Rd, Rd, Gg, Rd, Rd, Rd, Gs^Fp, Rd, Hh, Gg, Gg, Gg, Gg, Gg, Rr, Gg^Vh, Wo, Wo, Wo, Gg, Gg, Wo, Wo, Wo, Wo, Wo
Rd, Wo, Wo, Gs^Fds, Gs^Fds, Hh, Gg, Rp, Gg, Hh, Hh, Gs^Fms, Gs^Fms, Gg, Gg, Gg, Gg, Gs, Ds, Ss, Ss, Ss, Ss, Gs^Fp, Gs^Fms, Rd, Gs^Fp, Gg, Hh, Gs^Fmw, Gg^Ve, Hh, Gg, Gg, Hh, Hh, Gg, Gg, Rr, Rr, Gg, Gg, Re^Gvs, Wo, Wo, Gg, Wo, Wo, Wo, Wo, Ss, Ss
Hh, Rd, Wo, Ds, Ds, Gg, Gg^Vh, Rp, Rp, Gs^Fds, Re^Gvs, Gg, Gg, Hh, Mm, Mm, Mm, Gs, Ss, Ss, Ww, Ss, Ds, Gs^Fp, Gs^Fms, Gg^Ve, Gg, Gs^Fmw, Gs^Fmw, Gg, Gg, Gs^Fp, Gs^Fp, Gs^Fp, Gs^Fp, Gg, Gg, Rr, Hh, Gg, Gg, Re^Gvs, Re^Gvs, Wo, Wo, Wo, Wo, Wo, Wo, Wo, Ss, Ss
Mm^Xm, Rd, Gg^Vh, Wo, Ds, Gs^Fds, Re^Gvs, Re^Gvs, Rp, Re^Gvs, Re^Gvs, Re^Gvs, Gg, Gg, Hh, Mm, Hh, Ds, Wo, Wo, Wo, Wo, Wo, Gs^Fms, Wo, Hh, Gg, Gs^Fmw, Gs^Fp, Gs^Fp, Gs^Fp, Gg, Gs^Fp, Hh, Gg, Gg, Hh, Rr, Hh, Hh, Gg, Hh, Wo, Wo, Wo, Wo, Wo, Wo, Wo, Ss, Ss, Ss
Hh, Rd, Re^Gvs, Wo, Wo, Ds^Dr, Ww, Re^Gvs, Ww^Bw|, Re^Gvs, Ww, Gg^Vh, Gs^Fms, Gs^Fms, Hh^Fms, Hh, Ds, Wo, Gg, Ds, Gg, Gg, Gg^Vh, Wo, Gg, Wo, Wo, Gg, Gg, Gg, Gg, Gg, Gg, Gg, Gg, Gg, Rr, Gg^Vc, Gg, Hh, Gg, Gg, Gg^Vc, Wo, Wo, Wo, Wo, Wo, Ss, Ss^Vhs, Ss, Ss
Hh, Rd, Hh, Re^Gvs, Wo, Wo, Re^Gvs, Ww, Rp, Ww, Re^Gvs, Ww, Ww, Gs^Fms, Wo, Ds, Wo, Wo, Gg^Vh, Gg, Gg, Gg, Re, Gg, Gg, Ds, Wo, Gg, Gs^Fp, Gg, Gg, Gg, Gg, Gg, Gg, Gg, Rr, Gg, Hh, Gs^Fp, Rr, Rr, Hh, Hh, Wo, Wo, Wo, Wo, Ss, Rd, Gs^Ft, Gs^Ft
Hh, Hh, Hh, Hh, Wo, Re^Gvs, Gg^Vh, Re^Gvs, Gg, Rp, Re^Gvs, Re^Gvs, Re^Gvs, Wo, Hh, Wo, Hh, Gg, Hh, Hh, Hh, Gg, Gg, Re, Re, Gg, Gg^Vh, Wo, Wo, Gs^Fp, Gg, Gg, Hh, Gs^Fp, Gg, Hh, Gg, Rr, Rr, Rr, Gg^Vc, Hh, Re^Gvs, Hh, Wo, Wo, Wo, Wo, Ss, Ds, Ds, Gs^Ft
Re^Gvs, Gg, Re^Gvs, Wo, Re^Gvs, Re, Gg, Gs, Gs^Fms, Rp, Gg^Vh, Hh, Hh, Ds^Dr, Ds, Hh, Hh, Hh, Mm, Mm, Mm, Hh, Gg, Gg, Gg, Re, Gg, Gg, Ww, Gg, Gg, Gg, Gg, Gg, Gg, Gg, Gg, Hh, Gs^Fp, Rr, Re^Gvs, Hh, Re^Gvs, Re^Gvs, Wo, Wo, Wo, Wo, Ss, Gs^Ft, Ds, Ss
Re^Gvs, Re^Gvs, Wo, Wo, Re^Gvs, Re, Gs, Hh, Hh, Rp, Gg, Hh, Gg, Ds, Ww, Hh, Hh, Mm, Mm^Xm, Mm^Xm, Mm, Hh, Hh, Gg, Gg, Re, Re, Gg, Ww, Gg, Gg, Gg^Vh, Gg, Gg, Gg, Gg, Gg, Gs^Fp, Gs^Fp, Hh^Fp, Hh, Re^Gvs, Wo, Wo, Wo, Wo, Ds, Ss, Ss, Rd, Ss, Ss
Re^Gvs, Re^Gvs, Wo, Re^Gvs, Re^Gvs, Re, Gs, Ds, Rp, Rp, Gs^Fms, Gg, Gg, Gg, Gg, Ww, Hh, Mm, Mm^Xm, Mm, Mm, Hh, Hh, Gg, Gg, Re, Gg, Ww^Bw\, Rp, Gg, Gg, Gg, Gg, Gg, Re^Gvs, Re^Gvs, Re^Gvs, Hh, Mm, Mm^Xm, Mm^Xm, Hh^Fmw, Wo, Wo, Wo, Wo, Wo, Ds, Wo, Ss^Vhs, Ss, Ss
Wo, Wo, Gg^Vh, Re, Re, Re, Re, Gg^Vh, Rp, Gg, Gg, Gg, Gg, Gg^Vh, Gs^Fms, Ww, Hh, Mm, Mm^Xm, Mm, Hh, Hh, Gg, Gg^Vh, Re, Re, Gg, Ww, Gs^Fp, Rp, Rp, Gg, Gg, Re^Gvs, Re^Gvs, Re^Gvs, Re^Gvs, Hh, Gg, Hh, Hh, Hh, Wo, Wo, Wo, Wo, Wo, Wo, Wo, Wo, Wo, Ss
Ds, Ds, Gg, Gg, Hh, Hh, Gg, Gg, Rp, Gg, Hh, Hh, Gg, Gs^Fms, Gs^Fms, Hh, Hh, Mm, Hh, Hh, Hh, Hh, Gg, Re, Gg, Gg, Gg, Wo, Gg, Gg^Vh, Gg, Rp, Rp, Re^Gvs, Rp, Re^Gvs, Gg, Gg, Gg, Gg, Gg, Hh, Gg, Wo, Wo, Wo, Wo, Wo, Wo, Wo, Wo, Wo
Gs, Gs, Gg, Gg, Gg, Hh, Gs^Fms, Gs^Fms, Rp, Gg, Gg, Gg, Gs^Fms, Gg, Hh, Hh, Mm^Xm, Mm, Hh, Gs^Fp, Gg, Gg, Gg, Re, Gg, Gg, Gg, Wo, Wo, Gg, Gg, Gg, Gg, Rp, Gg, Rp, Gg^Vh, Gg, Gg, Gg, Ww, Gg^Vh, Gg, Gg, Gs^Fp, Wo, Wo, Wo, Wo, Wo, Wo, Wo
Hh, Gg, Gg, Gs^Fms, Gs^Fms, Gg, Gg, Gg, Rp, Gg^Vh, Gs^Fms, Gs^Fms, Hh, Hh, Hh, Mm, Mm^Xm, Mm, Hh, Hh, Gg, Gg, Gg, Re, Re, Hh, Gg, Ds, Ds, Wo, Mm, Mm, Mm, Gg, Gg, Gg, Gg, Rp, Gs^Fp, Ww, Ww, Re^Gvs, Gg, Gg, Gg, Gg, Wo, Wo, Wo, Ds, Wo, Wo
Hh, Hh, Gg, Gs^Fms, Gg, Gg, Gg, Rp, Hh, Hh, Hh, Hh, Mm^Xm, Mm^Xm, Mm^Xm, Mm, Hh, Hh, Gs^Fp, Gg, Gs^Fp, Gs^Fp, Gg, Gg, Gg, Re, Gg, Gg, Ds, Wo, Wo, Mm, Hh, Gg, Hh, Gg, Gg, Rp, Rp, Ww, Re^Gvs, Gs^Fp, Gg, Gg^Wm, Gg, Gg, Ds, Wo, Wo, Wo, Wo, Wo
Hh, Gg, Gg, Gg, Gg, Gs^Fms, Hh, Rp, Hh, Hh, Mm^Xm, Mm, Mm^Xm, Mm^Xm, Mm^Xm, Gs^Fp, Hh, Gs^Fp, Gg^Fet, Gs^Fp, Gg, Gg, Hh, Gs^Fp, Gs^Fp, Re, Gg^Vh, Gg, Gg, Ds, Gg, Ww, Hh, Hh, Re^Gvs, Re^Gvs, Gg, Gg, Rp, Re^Gvs, Re^Gvs, Gg, Gg, Gg, Gg, Gg^Vh, Gg, Ds, Wo, Wo, Wo, Ds
Re^Gvs, Hh, Hh, Gg, Gg, Hh, Gg, Rp, Hh, Mm^Xm, Mm, Mm^Xm, Mm, Mm^Xm, Hh, Hh, Gg, Gg, Gg, Gg^Ve, Gs^Fp, Gg, Gg, Gg^Fet, Re^Gvs, Re, Re, Gg, Re^Gvs, Gg, Gg, Ww, Ww, Ww, Ww, Re^Gvs, Gg, Gg^Vh, Gg, Rp, Rp, Gg^Vh, Hh, Gg, Re^Gvs, Re^Gvs, Gg, Wo, Wo, Wo, Wo, Wo
Re^Gvs, Hh, Mm, Hh, Gg, Gg, Rd, Rp, Re^Gvs, Hh, Hh, Wo, Hh, Gs^Fp, Gs^Fp, Gg^Fet, Gg^Ve, Gs^Fp, Wo, Gs^Fp, Gg^Fet, Gs^Fp, Gg, Gg, Gs^Fp, Re^Gvs, Re, Gg, Gg, Re^Gvs, Gg, Gg, Hh, Hh, Hh, Wo, Ds, Ds, Ds, Gg, Wo, Hh, Hh, Gg, Gg, Gg, Gg, Gg^Vh, Wo, Wo, Wo, Wo
Rd, Rd, Rd, Gg^Vc, Rd, Rd, Rd, Re^Gvs, Re^Gvs, Gg, Gg, Wo, Wo, Gs^Fp, Wo, Gs^Fp, Wo, Wo, Mm, Wo, Wo, Wo, Wo, Gg, Gg, Re^Gvs, Re^Gvs, Re, Re, Gg^Vh, Gg, Gg, Hh, Mm, Hh, Wo, Wo, Wo, Wo, Wo, Re^Gvs, Wo, Wo, Hh, Wo, Gg, Wo, Wo, Wo, Wo, Wo, Wo
Gg, Hh, Gg, Rd, Hh, Hh, Gs^Fms, Gg^Vc, Hh, Gs^Fp, Gs^Fp, Ds, Ds, Wo, Gs^Fms, Wo, Gs^Fms, Gg, Gg^Vh, Hh, Gg, Gg, Gg, Wo, Ds, Gs^Fp, Gg, Gg, Re, Gg, Gg, Hh, Mm, Mm, Mm, Hh, Re^Gvs, Gg^Vh, Re, Re^Gvs, Re^Gvs, Re^Gvs, Re^Gvs, Wo, Re^Gvs, Wo, Re^Gvs, Wo, Wo, Mm^Xm, Wo, Wo
Hh, Hh, Gg^Vc, Rd, Gg, Mm, Re^Gvs, Gg, Gg, Gg, Gg, Gg, Gg, Gg, Rd, Gs^Fms, Rd, Rd, Re^Gvs, Rd, Rd, Gs^Fms, Gg, Wo, Wo, Ds, Ds, Gg, Gg, Re, Gg, Hh, Hh, Mm, Hh, Hh, Hh, Re^Gvs, Hh, Re, Re, Gg^Vh, Re, Re, Re, Re^Gvs, Gg^Vh, Wo, Wo, Mm, Wo, Wo
Re^Gvs, Ss, Rd, Rd, Hh^Fds, Re^Gvs, Re^Gvs, Gg, Hh, Gg, Gg, Gg, Dd, Gg, Gg^Vh, Rd, Rd, Rd, Re^Gvs, Re^Gvs, Rd, Rd, Rd, Gg^Vh, Re^Gvs, Wo, Wo, Ds, Gg, Re, Gg, Gg, Gg, Hh, Hh, Hh, Mm^Xm, Hh, Mm, Hh, Hh, Gs^Fmf, Hh^Fmf, Re^Gvs, Re, Re, Wo, Wo, Wo, Wo, Wo, Wo
Gs^Fp, Re^Gvs, Rd, Hh^Fds, Hh, Hh, Gg^Vc, Gg, Mm, Hh, Dd, Dd, Dd, Gs, Gg, Rd, Rd, Rd, Rd, Rd, Gg, Gg, Gs^Fms, Rd, Re^Gvs, Re^Gvs, Wo, Ds, Gg, Re, Re, Gg, Gg, Hh, Hh, Mm^Xm, Mm^Xm, Mm^Xm, Mm^Xm, Mm, Mm^Xm, Hh, Hh, Re^Gvs, Re, Re^Gvs, Wo, Wo, Wo, Wo, Wo, Wo
Hh, Gs^Fp, Rd, Hh, Hh, Gg, Gs^Fms, Gg, Gg, Gg, Gg, Dd, Gs, Gs, Gs, Gs^Fms, Gs^Fms, Gg, Rd, Gs, Gs, Gg, Gg, Rd, Rd, Re^Gvs, Re^Gvs, Wo, Wwf, Gg, Re, Gg, Gg, Gg, Re^Gvs, Hh, Ww, Mm, Mm, Mm^Xm, Mm, Hh, Hh, Hh, Re, Wo, Wo, Wo, Wo, Wo, Wo, Wo
Hh, Rd, Gg, Gg^Vc, Re^Gvs, Re^Gvs, Gs^Fms, Gs^Fms, Gg, Gg, Hh, Gg, Gs, Gs, Gs, Gs^Fms, Gg, Rd, Gg^Vh, Gs, Dd, Dd, Gg, Gg, Gg^Vh, Re^Gvs, Gg, Gg, Rd, Wwf, Re, Gg^Vh, Gg, Gg, Re^Gvs, Re^Gvs, Ww, Ww, Hh, Hh, Hh, Hh, Hh^Fdf, Gg, Re, Wo, Wo, Wo, Wo, Wo, Wo, Wo
Rd, Rd, Gg, Re^Gvs, Hh, Re^Gvs, Gs, Hh, Gg, Gs, Gs, Gs, Gs, Gs, Gs, Gg, Rd, Rd, Dd, Gs, Dd, Dd, Gg, Gg, Rd, Rd, Rd, Rd, Rd, Wwf, Wo, Re, Re, Gg, Gg, Gg, Re^Gvs, Re^Gvs, Re^Gvs, Hh^Fdf, Gg, Gg, Gg, Gg, Re, Gg^Vh, Wo, Wo, Wo, Wo, Wo, Wo
Hh^Fmf, Gs^Fdf, Ss, Hh, Hh, Gg, Re^Gvs, Gg, Gs, Gs, Dd, Gs, Dd, Gs, Rd, Rd, Dd, Dd, Dd, Dd, Dd, Dd, Dd, Gg, Rd, Gs, Gs, Gs, Gs, Rd, Wo, Gg, Gg, Re, Gg^Vh, Gg, Gg, Re^Gvs, Re^Gvs, Gg, Gg, Gg, Gg, Re, Gg, Gg, Ds, Wo, Wo, Mm, Wo, Wo
Mm, Hh^Fmf, Hh, Hh^Fmf, Hh, Re^Gvs, Re^Gvs, Gg, Gg, Gs, Gs, Dd, Gs, Gs, Rd, Rd, Dd, Hd, Md, Md, Md, Hd, Dd, Dd, Rd, Gs, Gg, Gs, Gs, Rd, Gg^Vh, Wo, Gg, Gg, Gg, Re, Gg, Re^Gvs, Re^Gvs, Gs^Fmf, Gs^Fdf, Gg, Gg^Vh, Re, Wo, Wo, Wo, Wo, Wo, Mm, Hh, Wo
Re^Gvs, Hh, Mm, Mm, Mm, Hh, Gs, Gs, Gg, Gs, Gs, Gs, Gs, Gs, Dd^Vdt, Dd, Dd, Hd, Md, Md^Xm, Hd, Dd, Rd, Rd, Gg, Gg, Dd, Gg, Gs, Rd, Rd, Wo, Wo, Gg, Ds, Re, Re, Gg, Gg, Gs^Fmf, Gg, Gg, Re, Gg, Wo, Wo, Gs^Fdf, Wo, Wo, Wo, Hh, Hh
Gs^Fdf, Hh^Fmf, Hh^Fmf, Mm, Hh, Hh, Gg, Gs^Fmf, Gs^Fmf, Gg, Gg, Gg, Gg, Gs, Dd, Dd, Dd, Dd^Do, Dd, Hd, Dd, Dd, Rd, Rd, Rd, Gg, Gg, Dd, Dd, Gs, Gs, Rd, Wo, Ds, Ds, Gg, Gg, Gg^Vh, Re, Gg, Re, Re, Gg, Ww, Ww, Wo, Gg, Wo, Gg^Vc, Hh, Hh, Gs^Fdf
Gg, Ss, Gs, Hh, Hh, Gg^Vh, Rd, Hh, Re^Gvs, Gg, Dd, Gg, Gg, Gg, Gg, Dd, Dd^Vdt, Dd, Dd, Dd, Rd, Rd, Gg, Gg, Rd, Gg^Vh, Gs, Dd, Dd, Gs, Gs, Rd, Gg, Wo, Wo, Wo, Wo, Gg, Wo, Re, Gg, Gg, Ww, Ww, Gg, Hh, Gg, Gg, Hh, Gg, Gg, Hh
Rd, Gs, Gs, Re^Gvs, Re^Gvs, Hh, Hh, Rd, Gg, Gg, Gg, Dd, Gg, Gg, Gg, Gg, Rd, Rd, Rd, Rd, Gs, Gs, Gs, Gg, Gg, Rd, Rd, Gs, Gs, Gs, Gg^Vh, Rd, Gg, Gg, Gg, Gg, Gg, Wo, Gs^Fdf, Wo, Wo, Hh^Fdf, Ww, Ww, Ww, Gg, Hh, Hh, Gg, Gg, Hh, Gg
Dd, Rd, Rd, Gs, Rd, Hh, Rd, Gg^Vh, Dd, Gg, Gs, Gg, Gs^Fmf, Gs^Fmf, Gg, Gg, Gg, Gs, Gs, Rd, Gs, Gs, Dd, Gs, Rd, Rd, Gs, Rd, Rd, Rd, Gg, Gg, Gg, Gg, Gg, Gg, Gs^Fdf, Gs^Fdf, Hh^Fdf, Gs^Fdf, Gs^Fmf, Wo, Hh, Ww, Ww, Gg^Vc, Gg, Hh, Rr, Gs^Fdf, Mm, Gg
Md, Dd, Dd, Rd, Hd, Rd, Gs, Gg, Gg, Gg, Gg, Gg, Gg, Gs^Fmf, Gs, Gg, Gg, Gs, Gg, Gs, Gs, Dd, Gs, Gs, Rd, Gs, Gs, Gs, Rd, Gg, Gg, Hh, Gg, Gs^Fmf, Gs^Fmf, Gs^Fmf, Gg, Hh, Gs^Fdf, Gs^Fdf, Rd, Hh^Fdf, Rd, Gg, Ww^Bw/, Rr, Gs^Fmf, Rr, Hh, Rr, Rr, Gg
Md, Hd, Hd, Dd, Hd, Hd, Dd, Gs, Dd, Gg, Gs, Gs, Gs, Gs, Gs, Gs, Gs, Gg, Dd, Gg, Gg, Gs, Dd, Rd, Dd, Gs, Dd, Gs, Rd, Gg, Hh, Gg, Gg, Hh^Fdf, Gs^Fdf, Gg, Gs^Fmf, Gg^Ve, Gg, Rd, Gg, Rd, Hh, Rd, Gg, Ww, Gg, Hh, Hh, Gs^Fdf, Rr, Gg
Md^Xm, Md, Dd, Dd, Dd, Hd, Dd, Dd, Hd, Dd, Dd, Dd, Dd, Gs, Dd, Dd, Dd, Dd, Hd, Dd, Dd, Dd, Hd, Dd^Vda, Dd, Dd, Hd, Dd, Rd, Hh, Ds, Mm, Rd, Gg, Gs^Fdf, Gs^Fdf, Gs^Fdf, Gs^Fmf, Rd, Rd, Hh^Fdf, Gg, Gg, Gs^Fdf, Gg, Wo, Gs^Fdf, Gg, Gg, Gg^Vc, Gg, Rr
Md^Xm, Md, Dd, Dd, Rr^Vd, Rd, Dd, Hd, Dd, Dd, Hd, Hd, Hd, Dd, Dd, Dd, Hd, Hd, Md^Xm, Hd, Hd, Dd, Dd, Rd, Dd, Hd, Dd, Dd, Dd, Rd, Dd, Rd, Ds, Rd, Gs^Fdf, Gs^Fdf, Rd, Hh^Fdf, Rd, Gs^Fdf, Gg, Gg, Gg, Hh, Wo, Wo, Gs^Fdf, Gs^Fdf, Gg, Gg, Hh, Gg
Md^Xm, Hd, Dd, Dd, Dd, Dd, Dd, Dd, Rd, Dd, Dd, Dd, Dd, Dd, Hd, Hd, Md, Md^Xm, Md^Xm, Md, Md, Hd, Hd, Rd, Dd, Dd, Hd, Dd, Dd, Dd^Vda, Gs^Ft, Ds, Ds, Rd, Rd, Rd, Gs^Fdf, Rd, Gs^Fdf, Gg^Ve, Gs^Fdf, Hh, Gg, Gg, Ww, Gg, Gg, Gg, Hh, Hh, Gg, Gg
Hd, Hd, Dd, Hd, Dd, Dd, Dd, Dd, Dd, Rr^Vd, Dd, Hd, Dd, Dd, Dd, Md, Md, Md^Xm, Md^Xm, Md, Md, Md, Hd, Dd^Vda, Rd, Dd, Dd, Dd, Dd, Ss, Ww, Dd^Do, Ds, Ds, Ww, Gs^Fdf, Gs^Fdf, Gs^Fdf, Hh^Fdf, Gs^Fdf, Gs^Fdf, Gs^Fdf, Gs^Fdf, Ww^Bw\, Hh, Hh, Gg^Vc, Gg, Gg, Hh, Gs^Fdf, Gg
Md, Hd, Dd, Dd, Hd, Dd^Dc, Hd, Dd, Dd, Dd, Ss, Dd, Dd, Hd, Dd, Dd^Do, Md, Md^Xm, Md^Xm, Md^Xm, Md, Md, Md, Hd, Hd, Rd, Dd, Dd, Hd, Ss, Ww, Ss, Dd, Dd^Do, Ww, Ww, Gs^Fdf, Gs^Fdf, Gs^Fdf, Gs^Fdf, Hh, Gs^Fdf, Wo, Ww, Gs^Fdf, Gg, Gg, Gg, Gg, Hh, Gg, Gg
Md, Hd, Dd, Dd, Dd, Dd, Dd, Dd, Dd, Dd, Dd, Dd, Dd, Dd, Dd, Md, Md^Xm, Md^Xm, Md^Xm, Md^Xm, Md, Md, Md, Md, Hd, Rd, Dd, Dd, Dd, Ww, Dd, Hd, Dd, Ds, Ds, Ww, Ww, Gs^Fdf, Gs^Fdf, Gs^Fdf, Gs^Fmf, Gs^Fmf, Wo, Gg, Gg, Gg, Gg, Gs^Fdf, Gs^Fdf, Gg, Ds, Ds
Xv, Xv, Xv, Xv, Xv, Xv, Xv, Xv, Xv, Xv, Xv, Xv, Xv, Xv, Xv, Xv, Xv, Xv, Xv, Xv, Xv, Xv, Xv, Xv, Xv, Xv, Xv, Xv, Xv, Xv, Xv, Xv, Xv, Xv, Xv, Xv, Xv, Xv, Xv, Xv, Xv, Xv, Xv, Xv, Xv, Xv, Xv, Xv, Xv, Xv, Xv, Xv
Xv, Xv, Xv, Xv, Xv, Xv, Xv, Xv, Xv, Xv, Xv, Xv, Xv, Xv, Xv, Xv, Xv, Xv, Xv, Xv, Xv, Xv, Xv, Xv, Xv, Xv, Xv, Xv, Xv, Xv, Xv, Xv, Xv, Xv, Xv, Xv, Xv, Xv, Xv, Xv, Xv, Xv, 1 Xv, Xv, 2 Xv, Xv, 3 Xv, Xv, 4 Xv, Xv, Xv, Xv
Xv, Xv, Xv, Xv, Xv, Xv, Xv, Xv, Xv, Xv, Xv, Xv, Xv, Xv, Xv, Xv, Xv, Xv, Xv, Xv, Xv, Xv, Xv, Xv, Xv, Xv, Xv, Xv, Xv, Xv, Xv, Xv, Xv, Xv, Xv, Xv, Xv, Xv, Xv, Xv, Xv, Xv, Xv, Xv, Xv, Xv, Xv, Xv, Xv, Xv, Xv, Xv
Xv, Xv, Xv, Xv, Xv, Xv, Xv, Xv, Xv, Xv, Xv, Xv, Xv, Xv, Xv, Xv, Xv, Xv, Xv, Xv, Xv, Xv, Xv, Xv, Xv, Xv, Xv, Xv, Xv, Xv, Xv, Xv, Xv, Xv, Xv, Xv, Xv, Xv, Xv, Xv, Xv, Xv, Xv, Xv, Xv, Xv, 6 Xv, Xv, 5 Xv, Xv, Xv, Xv
Xv, Xv, Xv, Xv, Xv, Xv, Xv, Xv, Xv, Xv, Xv, Xv, Xv, Xv, Xv, Xv, Xv, Xv, Xv, Xv, Xv, Xv, Xv, Xv, Xv, Xv, Xv, Xv, Xv, Xv, Xv, Xv, Xv, Xv, Xv, Xv, Xv, Xv, Xv, Xv, Xv, Xv, Xv, Xv, Xv, Xv, Xv, Xv, Xv, Xv, Xv, Xv
Xv, Xv, Xv, Xv, Xv, Xv, Xv, Xv, Xv, Xv, Xv, Xv, Xv, Xv, Xv, Xv, Xv, Xv, Xv, Xv, Xv, Xv, Xv, Xv, Xv, Xv, Xv, Xv, Xv, Xv, Xv, Xv, Xv, Xv, Xv, Xv, Xv, Xv, Xv, Xv, Xv, Xv, Xv, Xv, Xv, Xv, Xv, Xv, Xv, Xv, Xv, Xv
Xv, Xv, Xv, Xv, Xv, Xv, Xv, Xv, Xv, Xv, Xv, Xv, Xv, Xv, Xv, Xv, Xv, Xv, Xv, Xv, Xv, Xv, Xv, Xv, Xv, Xv, Xv, Xv, Xv, Xv, Xv, Xv, Xv, Xv, Xv, Xv, Xv, Xv, Xv, Xv, Xv, Xv, Xv, Xv, Xv, Xv, Xv, Xv, Xv, Xv, Xv, Xv
