Xv, Xv, Xv, Xv, Xv, Xv, Xv, Xv, Xv, Xv, Xv, Xv, Xv, Xv, Xv, Xv, Xv, Xv, Xv, Xv, Xv, Xv, Xv, Xv, Xv, Xv, Xv, Xv, Xv, Xv, Xv, Xv, Xv, Xv, Xv, Xv, Xv, Xv, Xv, Xv, Xv, Xv, Xv, Xv, Xv, Xv, Xv, Xv, Xv, Xv, Xv, Xv
Xv, Xv, Xv, Xv, Xv, Xv, Xv, Xv, Xv, Xv, Xv, Xv, Xv, Xv, Xv, Xv, Xv, Xv, Xv, Xv, Xv, Xv, Xv, Xv, Xv, Xv, Xv, Xv, Xv, Xv, Xv, Xv, Xv, Xv, Xv, Xv, Xv, Xv, Xv, Xv, Xv, Xv, Xv, Xv, Xv, Xv, Xv, Xv, Xv, Xv, Xv, Xv
Xv, Xv, Xv, Xv, Xv, Xv, Xv, Xv, Xv, Xv, Xv, Xv, Xv, Xv, Xv, Xv, Xv, Xv, Xv, Xv, Xv, Xv, Xv, Xv, Xv, Xv, 1 Xv, Xv, 2 Xv, Xv, 3 Xv, Xv, 4 Xv, Xv, 5 Xv, Xv, 6 Xv, Xv, Xv, Xv, Xv, Xv, Xv, Xv, Xv, Xv, Xv, Xv, Xv, Xv, Xv, Xv
Xv, Xv, Xv, Xv, Xv, Xv, Xv, Xv, Xv, Xv, Xv, Xv, Xv, Xv, Xv, Xv, Xv, Xv, Xv, Xv, Xv, Xv, Xv, Xv, Xv, Xv, Xv, Xv, Xv, Xv, Xv, Xv, Xv, Xv, Xv, Xv, Xv, Xv, Xv, Xv, Xv, Xv, Xv, Xv, Xv, Xv, Xv, Xv, Xv, Xv, Xv, Xv
Xv, Xv, Xv, Xv, Xv, Xv, Xv, Xv, Xv, Xv, Xv, Xv, Xv, Xv, Xv, Xv, Xv, Xv, Xv, Xv, Xv, Xv, Xv, Xv, Xv, Xv, Xv, Xv, Xv, Xv, Xv, Xv, Xv, Xv, Xv, Xv, Xv, Xv, Xv, Xv, Xv, Xv, Xv, Xv, Xv, Xv, Xv, Xv, Xv, Xv, Xv, Xv
Ds, Xv, Ds, Xv, Ds, Xv, Ds, Xv, Ss, Xv, Ss, Xv, Ds, Xv, Ss, Xv, Ss, Xv, Ss, Xv, Ss, Xv, Ds, Xv, Dd, Xv, Dd, Xv, Dd, Xv, Dd, Xv, Dd, Xv, Dd, Xv, Dd, Xv, Dd, Xv, Dd, Xv, Hd, Xv, Md, Xv, Md, Xv, Md, Xv, Md, Xv
Ss, Ds, Ds, Ds, Ds, Ds, Gs^Ft, Ds, Ss, Ss, Ds, Ss, Ds, Ds, Ss, Ss, Ss, Ss, Ds, Ss, Ss, Ds, Dd, Dd, Hd, Dd, Dd, Dd, Hd, Dd, Dd^Vdt, Hd, Dd, Dd, Dd, Hd, Ds, Hd, Dd, Dd, Dd, Hd, Md, Md, Md, Md, Md, Md, Md, Md, Md^Xm, Md^Xm
Ds, Ss, Ss, Ss, Ss, Ss, Gs^Ft, Gs^Ft, Ss, Ds, Ss, Ss, Ss, Ss, Gs^Ft, Gs^Ft, Gs^Ft, Ss, Ds, Ds, Gs^Ft, Ds, Ds, Hd, Dd, Dd, Dd, Hd, Ds, Rd, Ds, Dd, Dd, Hd, Dd, Dd, Hd, Ds, Dd^Dc, Md, Dd, Hd, Md, Md, Md, Md, Md, Rd, Rr^Vd, Md^Xm, Md^Xm, Md^Xm
Ss, Gs^Ft, Ss, Ds, Ds, Ss, Ss, Ss, Gs^Ft, Ss, Ds, Ss^Vhs, Gs, Ss, Ss, Ss, Ss, Ss, Gs^Ft, Gs^Ft, Ss, Gs^Ft, Gs, Ds, Ds, Dd, Ds, Dd, Ds, Dd, Dd, Ds, Dd, Ds, Dd^Vdt, Dd^Dr, Dd, Dd, Dd, Dd, Dd, Hd, Hd, Hd, Hd, Hd, Hd, Hd, Hd, Md^Xm, Md^Xm, Md^Xm
Ss, Ds, Ss, Ds, Gs, Ss^Vhs, Ss, Gs, Ss, Ss, Ss, Ss, Ss, Ds, Ss, Gs^Ft, Rd, Ds, Ds, Ss, Gs^Ft, Gs^Ft, Gs^Ft, Gs, Gs, Ds, Ds, Ds, Dd^Vdt, Dd, Dd, Hd, Dd, Rd, Ds, Dd, Dd, Hd, Ds, Hd, Ds, Dd, Rd, Rr^Vd, Hd, Hd, Md, Md, Md^Xm, Md^Xm, Md^Xm, Md^Xm
Gs, Ss, Gs^Ft, Ss, Ss, Ss, Gs^Ft, Ss, Ds, Ss, Gs^Ft, Gs, Ss, Ss, Ds, Ss, Ss, Gs^Ft, Gs^Ft, Gs^Ft, Gs, Gg^Ve, Gs, Gs^Ft, Ss, Gs^Ft, Gs, Rd, Rd, Ds, Dd, Dd, Gs^Ft, Gs^Ft, Ww, Ds, Dd, Dd, Hd, Ds, Dd, Dd, Dd, Hd, Hd, Md, Md^Xm, Md^Xm, Md^Xm, Md^Xm, Md^Xm, Md^Xm
Gs, Ds, Ss, Ss, Ds, Ss, Gs, Ss, Ss, Gs^Ft, Gs^Ft, Ss, Ss, Ds, Ds, Ss, Gs, Gs, Gs^Ft, Ss, Gs^Ft, Gs^Ft, Gs^Ft, Ds, Gs, Gs^Ft, Ds, Gs, Ds, Ds, Dd, Dd, Gg, Dd^Do, Dd, Ds, Hd, Dd, Md, Dd, Dd, Hd, Dd, Dd, Dd, Md, Md, Md, Md, Md^Xm, Md, Md^Xm
Gg, Gs, Gs, Ss, Ds, Ds, Ss, Ss, Ss, Ss, Rd, Ds, Ss, Gs^Ft, Ss, Gs^Ft, Gs^Ft, Gs^Ft, Hh, Ds, Gs^Ft, Gs, Gs, Gs^Ft, Gs^Ft, Rd, Rd, Gs, Gs, Ds, Dd, Dd, Dd, Gs^Ft, Dd, Dd, Dd, Md, Md, Dd^Do, Dd, Dd, Hd, Dd, Dd, Dd, Hd, Md, Md, Md, Md, Md
Gg, Gg, Gs, Ds, Ds, Ds, Ss, Gs^Ft, Ss, Rd, Ds, Ss, Gs^Ft, Ds, Ss, Ss, Gg^Ve, Gs, Gs^Ft, Gs^Ft, Ss, Ss, Gs^Ft, Gs^Ft, Ss, Gs^Ft, Gs, Gs^Ft, Gs, Ds, Ds, Dd, Hd, Dd, Dd, Hd, Dd, Hd, Dd, Hd, Hd, Dd, Dd, Dd, Md, Dd, Dd, Hd, Hd, Hd, Hd, Hd
Gg, Gg, Gg^Vh, Gs, Gs, Ss, Ss, Ss, Gs, Ds, Gs^Ft, Ss, Ss, Rd, Rd, Gs^Ft, Gs^Ft, Gs^Ft, Gs^Ft, Gs^Ft, Gs^Ft, Ss, Ds, Ss, Gs, Gs^Ft, Gg^Ve, Gs^Ft, Hh, Gs, Ds, Dd, Dd, Dd, Hd, Ds, Dd, Hd, Ds, Dd, Dd, Dd, Dd, Dd, Dd, Dd, Dd, Ds, Wo, Wo, Wo, Ds
Gg, Gg, Gg, Gg, Wo, Wo, Gs, Gs, Gs, Gs, Gg, Gs, Gs, Gs^Ft, Gs, Gs, Gs^Ft, Ss, Ds, Gs^Ft, Gs^Ft, Ss, Gs^Ft, Gs^Ft, Gs^Ft, Gs, Gs^Ft, Rp, Gs, Gs, Hd, Dd, Dd, Dd, Dd, Dd, Dd, Dd, Dd, Dd, Dd, Dd^Dc, Dd, Hd, Dd, Hd, Dd, Ds, Wo, Wo, Ds, Ds
Gg, Gg, Hh^Fp, Gg, Wo^Bw\, Hh, Gg, Gg^Vh, Gg, Gs^Ft, Gg, Hh, Gs, Gs, Gs, Gs^Ft, Gs^Ft, Gs^Ft, Gs^Ft, Rd, Gs^Ft, Rd, Gs^Ft, Gs^Ft, Hh, Gs^Ft, Rp, Rp, Gs^Ft, Gs, Gs, Ds, Dd, Hd, Dd, Dd, Dd, Hd^Dr, Dd^Vda, Dd, Dd, Dd, Dd, Hd, Dd, Dd, Dd, Wo, Wo, Wo, Ds, Ds
Gg, Hh, Wo, Ww, Re^Gvs, Gg, Gs, Hh, Gg, Gs, Gs, Gg, Gs^Ft, Hh, Ss, Gs, Gs, Gs, Gs^Ft, Gs^Ft, Gg^Ve, Gs^Ft, Gs^Ft, Hh, Gs^Ft, Gs, Rp, Hh, Gg, Gg, Wo, Ds, Dd, Dd, Dd, Hd, Hd, Dd, Rd, Dd, Hd, Dd, Hd, Dd, Dd, Dd, Dd, Wo, Wo, Wo, Wo, Ds
Gg, Hh^Fp, Wo, Re^Gvs, Gs^Fp, Gg, Hh, Gs, Hh^Fdw, Gg, Gg, Gg, Hh, Ss, Wwf, Gs, Gg, Gs, Gs^Ft, Gs, Gs, Gs^Ft, Gs, Gs^Ft, Gs, Gs^Ft, Rp, Gg, Ww, Gg, Wo, Ds, Ds, Dd, Dd, Dd, Dd, Dd, Dd, Dd, Dd, Hd, Dd, Dd, Rd, Hd, Wo, Wo, Ds, Wo, Wo, Wo
Gg, Gg, Wo, Re^Gvs, Hh, Gs^Fp, Hh, Gs, Gg, Hh, Gg, Gg, Gs, Gs, Gg, Hh, Gg, Gg, Gg, Gs, Hh, Hh, Hh, Gs, Gg, Gs, Ww, Ww^Bw\, Rr, Ww, Ww, Ww, Ww, Ds, Dd, Dd, Hd, Dd, Hd, Dd, Hd, Ds, Dd, Dd, Dd, Dd^Vda, Wo, Wo, Wo, Wo, Wo, Wo
Ww, Wwf, Re^Gvs, Hh, Gg, Gg^Vc, Gg, Gg, Rd, Gg, Re, Re, Re, Gg^Vh, Rp, Gg, Gg, Re^Gvs, Re^Gvs, Hh, Hh, Hh, Mm^Xm, Hh, Gg, Gg, Wo, Hh, Rr, Gg, Gg^Vh, Gg, Gg, Ds, Dd, Hd, Dd, Dd, Dd, Dd^Do, Gs^Ft, Dd, Hd, Dd, Dd, Ds, Ds, Wo, Wo, Wo, Wo, Wo
Hh, Gg, Gg, Hh, Rd, Rd, Rd, Rd, Hh, Rd, Gg, Gg, Gg, Gs^Fp, Gg, Rp, Rp, Re^Gvs, Hh, Hh, Mm^Xm, Mm^Xm, Wo, Hh, Wo, Wo, Gg, Gg, Gg, Rr, Gg, Gg, Hh, Ds, Dd, Hd, Dd, Rd, Dd, Dd, Hd, Dd, Rd, Hd, Dd, Dd, Ds, Wo, Wo, Wo, Dd, Wo
Hh, Gs^Fp, Rd, Rd, Hh, Gg, Gg^Vc, Hh, Hh, Gg, Gs^Fp, Gg, Hh, Gg, Hh, Gg, Gg, Gg^Vh, Hh, Mm^Xm, Mm, Mm, Hh, Wo, Gg^Vh, Gg, Gg, Gg, Gs, Rr, Re^Gvs, Hh, Hh, Gs, Ds, Dd, Rd, Dd^Vda, Hd, Hd, Md, Hd, Dd^Vda, Dd, Hd, Dd, Dd, Ds, Wo, Wo, Wo, Wo
Hh, Gs^Fp, Rd, Re^Gvs, Re^Gvs, Hh, Gg, Gg, Re^Gvs, Re^Gvs, Gg, Hh, Hh, Hh, Gg, Gg, Hh, Hh, Mm, Mm^Xm, Mm, Hh, Gg, Gg, Gg, Gg, Gs^Fp, Gs^Fp, Gs, Rr, Re^Gvs, Re^Gvs, Hh, Gs, Ds, Hd, Hd, Dd, Hd, Md, Md, Hd, Dd, Dd, Dd, Dd, Dd, Rd, Ds, Wo, Wo, Wo
Gg, Gg, Rd, Re^Gvs, Gg, Hh, Gg, Hh, Hh, Gg, Gg, Gg^Vc, Gg, Gg, Hh^Fdw, Gg, Hh, Hh, Mm^Xm, Mm^Xm, Hh, Hh, Gg, Gg, Gg, Gg, Re^Gvs, Re^Gvs, Re^Gvs, Rr, Gg, Re^Gvs, Gg^Vh, Gs, Gs, Ds, Dd, Dd, Hd, Hd, Hd, Ds, Ds, Dd, Dd, Dd, Ds, Dd^Vda, Wo, Wo, Wo, Ds
Gg, Rd, Gg, Gg^Vc, Hh, Gg, Gg, Gs^Fdw, Hh, Hh, Re^Gvs, Re^Gvs, Gg, Gg, Hh^Fdw, Hh, Mm, Mm, Mm^Xm, Mm, Hh, Gg, Gg, Hh, Gg, Gg, Gg, Re^Gvs, Rr, Rr, Gg, Gg, Gs, Gs, Hh, Ds, Ds, Dd, Dd, Hd, Dd, Ds, Hd, Dd, Hd, Dd, Ds, Wo, Wo, Wo, Wo, Ds
Re, Re, Gg, Hh, Gg, Gg, Gs^Fp, Hh, Gg, Gg, Gs^Fp, Re^Gvs, Hh, Hh^Fdw, Hh^Fdw, Mm, Mm, Mm^Xm, Mm, Hh, Gg^Vh, Gg, Rp, Gg, Gg, Gg^Vh, Rp, Rr, Rr, Gs^Fp, Gg, Re^Gvs, Re^Gvs, Gs, Gs, Gs, Ds, Hd, Dd, Hd, Rd, Dd^Vda, Dd, Dd, Ds, Dd, Ds, Wo, Wo, Wo, Wo, Wo
Gg, Gg, Gg, Gg, Gg, Hh, Ww, Gs^Fp, Hh, Gg, Gs^Fp, Gg, Gg^Vc, Gg, Hh, Mm, Mm^Xm, Mm^Xm, Hh, Hh, Gg, Rp, Re^Gvs, Rp, Rp, Rp, Ww, Re^Gvs, Re^Gvs, Rr, Gg^Vh, Re^Gvs, Gg, Gg, Gg, Gg, Gs, Ds, Ds, Dd, Dd, Hd, Dd, Ds, Ww, Ds, Ds, Ds, Wo, Wo, Wo, Wo
Gg, Gg, Gs^Fdw, Hh, Hh, Gs^Fp, Ww, Ww, Gg, Gg, Re^Gvs, Gg, Gg, Hh, Hh, Mm, Mm^Xm, Hh, Gg, Gg, Hh, Re^Gvs, Gs^Fp, Gg, Re^Gvs, Re^Gvs, Ww, Ww, Rr, Rr, Gg, Gg, Gg, Hh, Gg, Gs, Gs, Gs, Gs, Ds, Hd, Ds, Gs^Ft, Gs^Ft, Dd^Do, Ww, Ds, Ds, Wo, Wo, Wo, Wo
Re, Gg, Gg, Hh, Gg, Gg, Gg, Gs^Fp, Gg, Re^Gvs, Re^Gvs, Gs^Fmw, Gg, Gg, Hh, Hh, Mm, Mm, Gg, Hh, Hh, Gg, Gg, Gg, Gg, Re^Gvs, Hh, Gs, Rr, Hh, Re^Gvs, Gg, Gg, Gg, Gs, Gg, Gs, Gs, Gs, Ds, Dd, Dd, Dd, Gs^Ft, Gs, Ww, Ds, Wo, Wo, Wo, Wo, Wo
Re, Gs^Fp, Re^Gvs, Re^Gvs, Gg, Hh, Gg, Gg, Hh, Gg, Gg, Gg, Gg, Gg, Hh, Mm, Mm, Mm, Hh, Gg, Gg, Gg, Gg, Gg, Re^Gvs, Mm, Hh, Gg, Rr, Re^Gvs, Re^Gvs, Gg, Gs^Fp, Gg, Hh, Hh, Gs, Gs, Gs, Gs, Gs, Ds, Ds, Ds, Ds, Ds, Ds, Wo, Wo, Wo, Wo, Wo
Re, Gg, Gg, Re^Gvs, Gg, Gg, Gg, Gg, Gg, Hh, Gg, Hh, Gs^Fmw, Gs^Fmw, Gg, Hh, Mm, Mm^Xm, Mm, Gg^Vh, Gg, Gg, Gg, Re^Gvs, Re^Gvs, Re^Gvs, Gg, Gg, Rp, Gg, Gg, Gg, Gg, Gg, Hh, Hh, Gs, Gs, Gg, Gs, Gs, Gs, Gs, Ds, Gs, Ds, Ds, Ds, Wo, Wo, Wo, Wo
Gg, Re, Gg^Vh, Gg, Gg, Gs^Fp, Gg, Hh, Gg, Gg, Gs^Fmw, Gg, Mm, Gs^Fmw, Gg, Gg, Hh, Mm^Xm, Mm^Xm, Hh, Gg, Re^Gvs, Re^Gvs, Gg, Gg, Gg, Gg, Rp, Gg, Gg, Gg, Gg, Gg, Gg, Gs, Gs, Re^Gvs, Re^Gvs, Re^Gvs, Gg, Gs, Gs, Gs, Gs, Re^Gvs, Gs, Gg, Gg, Wo, Wo, Wo, Wo
Rp, Rp, Rp, Gg, Hh, Gg, Gg, Gg, Gg, Gg, Gs^Fmw, Mm, Mm, Mm, Gg^Vh, Gg, Gg, Hh, Mm^Xm, Mm, Hh, Re^Gvs, Re^Gvs, Gg, Gg, Gg, Gg, Rp, Rp, Gg, Gg, Gg, Gg^Vh, Gg, Gg, Gs, Re^Gvs, Re^Gvs, Gg, Gg, Hh, Gs, Gs, Re^Gvs, Re^Gvs, Gg, Rd, Gg^Vh, Wo, Wo, Wo, Wo
Gs^Fms, Gg, Gg, Rp, Rp, Gg, Gg, Gg, Gg, Gs^Fmw, Gg, Hh, Hh, Hh, Gg, Rp, Gg, Hh, Mm, Mm^Xm, Mm, Hh, Gg, Gg, Hh, Hh, Hh, Gg^Vh, Gg, Rp, Rp, Rp, Gg, Gg, Gg, Gg, Gg, Gg, Gg^Vh, Hh, Gs^Fp, Gs, Rd, Gs, Rd, Rd, Gg, Wo, Wo, Wo, Wo, Wo
Re^Gvs, Gg, Hh, Gg, Gg, Gg^Vh, Gg, Gg, Re^Gvs, Gg, Gg, Gg, Gg, Gg, Gg, Rp, Rp, Hh, Hh, Mm^Xm, Mm^Xm, Ww, Ww, Gg, Hh, Hh, Gg, Gg, Wo, Gg, Re, Rp, Rd, Rd, Ww, Gg, Rd, Rd, Gg, Rd, Rd, Rd, Gg, Rd, Gg, Gg, Re^Gvs, Wo, Wo, Wo, Wo, Wo
Re^Gvs, Gg, Gg, Gg, Gg, Gg, Gg, Gg, Re^Gvs, Re^Gvs, Gg, Gg, Gg, Gg, Gg, Hh, Rp, Gg, Gg^Vh, Hh, Hh, Hh, Gg, Ww, Wo, Wo, Wo, Wo, Re^Gvs, Wo, Ww, Ww^Bw|, Wwf, Ww, Wo, Ww, Gg, Gg, Gg, Gg, Gg, Gs^Fp, Gg, Rd, Rd, Hh, Gg, Re^Gvs, Wo, Wo, Wo, Wo
Gg, Gg^Vh, Gg, Gs^Fms, Gg, Gg, Gg, Re^Gvs, Re^Gvs, Re^Gvs, Gs^Fms, Gg, Gg, Gg^Vh, Hh, Gg, Gg, Rp, Gg, Gg, Gg, Gg, Gg, Gg, Gg, Gg, Re^Gvs, Re^Gvs, Hh, Rd, Rp, Rp, Gg, Ww, Ww, Ww, Gg, Gg, Hh, Re^Gvs, Re^Gvs, Gg^Vh, Gg, Gg, Rd, Gs^Fp, Gg, Gg^Vh, Wo, Wo, Wo, Wo
Gg, Gg, Gg, Gg, Gg, Gg, Gs^Fms, Gg, Gg, Gg, Gg, Gg, Gg, Gg, Gg, Gg, Gg, Rp, Gg, Gg, Gg, Gg, Gg, Gg, Gs^Fms, Gs^Fms, Gg, Re^Gvs, Gg^Vh, Gg, Rp, Gg, Gg, Gg, Gg, Ww, Gg, Gg, Re^Gvs, Re^Gvs, Re^Gvs, Gg, Gg, Hh, Rd, Gg, Gg, Wo, Wo, Wo, Gg, Wo
Hh^Fms, Gg, Gg, Gg, Gg, Hh^Fms, Hh, Gg, Gg, Gg, Gg, Gg, Gg, Gg, Gg, Gg, Gs^Fms, Rp, Gg, Gg, Gg, Hh, Hh, Gg, Re^Gvs, Gs^Fms, Re^Gvs, Gg, Gg, Gg, Rp, Gg, Gs^Fms, Gg, Gg, Ww, Ww, Gg, Re^Gvs, Re^Gvs, Hh, Gg, Hh^Fp, Gg, Gg, Rd, Gg, Wo, Wo, Wo, Wo, Wo
Gs^Fms, Gg, Gg, Gg, Gs^Fds, Gg, Gg, Gg, Gg, Hh, Gg, Gg, Hh, Gg, Gg, Gs^Fds, Rp, Rp, Gg, Gs^Fds, Gs^Fds, Hh, Gg, Re^Gvs, Re^Gvs, Re^Gvs, Gg, Gg, Re^Gvs, Gg, Gg, Rp, Gg, Gg, Hh, Gg, Wo, Hh, Gg, Hh^Fmw, Mm, Mm, Hh, Gg, Hh^Fp, Re, Wo, Wo, Wo, Wo, Wo, Wo
Hh, Gs^Fms, Gg, Gg, Gg, Gg, Gg, Gg, Gg, Gs^Fms, Gg, Gs^Fds, Hh^Fds, Gs^Fds, Hh, Gs^Fds, Rp, Gs^Fds, Gg, Gs^Fds, Gg, Gs^Fds, Hh, Gg, Rd, Re^Gvs, Gg, Gg, Hh, Re^Gvs, Gg, Rp, Rp, Gg, Gg, Gg, Gs^Fms, Wo, Gg, Hh^Fmw, Mm, Hh^Fmw, Hh, Gg, Gg, Re, Wo, Wo, Hh, Wo, Wo, Wo
Mm, Hh, Gs^Fms, Gg, Hh, Hh, Hh, Gg, Gg, Gg, Gs^Fds, Gg^Ve, Gs^Fms, Gg^Fet, Gg, Gs^Fds, Rp, Gg^Ve, Gs^Fms, Gg, Hh, Gg, Re, Gg, Rd, Gg^Vh, Gg, Hh, Re^Gvs, Gg, Gg, Gg, Gg^Vh, Gs^Fms, Gg, Gg, Gg, Wo, Re^Gvs, Gg, Gg, Gg, Gg^Vc, Gg, Re, Re, Wo, Wo, Hh^Fp, Wo, Wo, Wo
Mm, Mm, Mm, Gg, Mm, Mm, Mm, Gg, Gg, Gs^Fds, Hh, Gg, Hh, Gs^Fds, Rp, Rp, Gs^Fds, Gs^Fms, Gs^Fms, Re, Re, Re, Gg, Re, Re, Gg, Gg, Re^Gvs, Re^Gvs, Gg, Gs^Fms, Gg, Re, Gg, Gg, Gg, Wwf, Ww, Re^Gvs, Re^Gvs, Gg, Hh, Hh, Gg, Re, Gg, Gg, Wo, Wo, Hh^Fp, Wo, Wo
Mm, Mm, Mm, Mm^Vhh, Gg, Mm, Gs^Fds, Gg, Gg, Gs^Fds, Gg, Gs^Fds, Gs^Fds, Gs^Fms, Rp, Gs^Fds, Gg^Fet, Hh, Gg, Gg, Gg, Gs^Fms, Gg, Hh, Re, Gg, Gg, Gg, Gg, Gg, Gg, Gg, Re, Hh, Hh, Ww, Gs^Fms, Gg, Hh, Gg, Re, Gg, Re, Gg, Re, Gg, Gg, Wo, Wo, Wo, Wo, Wo
Mm^Xm, Hh, Hh, Hh, Hh, Hh^Fds, Gg, Hh, Gg, Gg, Gg, Gs^Fds, Rp, Gg^Ve, Hh, Gs^Fds, Gs^Fds, Gs^Fds, Gg, Gg, Hh, Gg, Gg, Gg, Rd, Re, Re, Re, Re, Gg, Re, Re, Gs^Fms, Gg, Wo, Wo, Re^Gvs, Hh, Gg^Vc, Re, Gg, Re, Hh, Re, Gg, Gg^Vc, Gg, Gg, Wo, Wo, Wo, Wo
Hh^Fds, Mm^Xm, Mm, Mm, Mm, Mm, Mm^Vhh, Gg, Hh, Gg, Gg, Rp, Gs^Fms, Gg, Gs^Fds, Gg, Gg, Gg, Gg, Gg, Gs^Fms, Hh, Gg, Gg^Vh, Rd, Gg, Hh, Hh, Gg, Re, Gg, Gg, Gg, Gg, Wo, Re^Gvs, Re^Gvs, Gg, Gg, Hh, Hh, Gg, Gg, Re, Re, Hh, Hh, Gg, Wo, Wo, Wo, Wo
Mm, Mm, Mm, Mm, Mm, Mm, Mm, Mm, Hh^Fms, Hh, Gg, Rp, Hh, Gs^Fds, Gs^Fds, Gg, Gg, Gg, Gg, Gg, Gg, Gg, Gg, Gg, Rd, Gg, Gg, Hh, Re^Gvs, Rd, Gg, Gs^Fms, Gg, Gg, Wwf, Re^Gvs, Gg, Gg, Gs^Fmw, Gg, Re^Gvs, Re^Gvs, Hh, Hh, Re, Hh, Gg^Vc, Wo, Wo, Wo, Wo, Wo
Mm, Mm, Mm^Xm, Mm^Xm, Mm, Mm, Mm, Mm, Mm^Xm, Hh, Hh, Rp, Rp, Gs^Fms, Gg, Gg, Hh, Gg, Mm, Hh, Gg, Gg, Gg, Rd, Hh, Gg, Re^Gvs, Re^Gvs, Re^Gvs, Gg^Vh, Gg, Gg, Hh, Gs^Fms, Wwr, Gg, Hh, Hh, Gg, Gg, Gg, Re^Gvs, Gg^Vc, Hh, Re, Gg, Gg, Wo, Wo, Wo, Wo, Wo
Gg, Mm, Mm, Mm, Mm, Mm, Mm, Mm^Xm, Mm, Mm, Hh, Gg, Gg, Rp, Rp, Gg, Gg, Mm, Mm, Mm, Hh, Gg, Rd, Rd, Hh, Hh, Hh, Re^Gvs, Hh, Gg, Hh, Hh, Mm, Ww, Gg, Gg, Gg, Hh, Gs^Fmw, Hh, Gg, Gs^Fmw, Gg, Re, Gg, Gs^Fmw, Wo, Wo, Wo, Wo, Wo, Wo
Hh, Hh, Mm, Hh, Hh, Mm, Mm, Mm^Xm, Hh, Hh^Fds, Gg, Gg, Hh^Fms, Gs^Fds, Rp, Hh, Hh^Fms, Hh, Hh, Hh, Hh, Rd, Gg, Hh, Hh, Mm, Mm, Mm^Xm, Mm, Hh, Mm, Mm, Hh, Ww, Gs^Fp, Gs^Fmw, Gg, Gg, Gg, Gg, Gs^Fmw, Gg, Gg, Re, Gg, Wo, Wo, Wo, Wo, Wo, Wo, Wo
